AOT	TERME EUGANEE-ABANO-MONTEGROTTO
AAL	ABBADIA LARIANA
ATA	ABBASANTA
ASO	ABBIATEGRASSO
ATE	ACATE
ANO	ACCIANO
ARA	ACERRA
ALE	ACIREALE
AAA	ACQUA ACETOSA
ADA	ACQUAFREDDA
AAC	ACQUANEGRA CREMONESE
ASA	ACQUAPPESA
AVA	ACQUAVIVA-CASTELTERMINI
ADF	ACQUAVIVA DELLE FONTI
ASF	ACQUEDOLCI-S.FRATELLO
AIT	ACQUI TERME
ABL	ACRI-BISIGNANO-LUZZI
AIA	ADRIA
AON	AFRICO NUOVO
ACC	AGLIANO-CASTELNUOVO CALCEA
AOB	AGRIGENTO BASSA
AOC	AGRIGENTO CENTRALE
AIC	AGROPOLI-CASTELLABATE
ACA	AIRASCA
ALL	AIROLE
ANN	AIRUNO
ALA	ALA
ANA	ALANNO
AFV	ALANO-FENER-VALDOBBIADENE
AIO	ALASSIO
ABA	ALBA
AAN	ALBA ADRIATICA-NERETO-CONTROGUERRA
ANI	ALBACINA
ADL	ALBANO DI LUCANIA
AOL	ALBANO LAZIALE
ASR	ALBANO S. ALESSANDRO
AVV	ALBANOVA
ADO	ALBAREDO
AEC	ALBATE-CAMERLATA
AET	ALBATE TRECALLO
AGA	ALBENGA
ASE	ALBERESE
AII	ALBINIA
ALO	ALBISOLA
ASN	ALBIZZATE-SOLBIATE ARNO
ASS	ALBONESE
ANZ	ALBUZZANO
AOD	ALCAMO DIRAMAZIONE
ARR	ALCANTARA
AIR	ALESSANDRIA
AAS	ALFEDENA-SCONTRONE
ANE	ALFONSINE
AEB	ALICE BELCOLLE
AIE	ALI TERME
ACV	ALLERONA-CASTEL VISCARDO
ANG	ALPIGNANO
ARU	ALTAMURA
ARE	ALTARE
AAI	ALTAVILLA IRPINA
AAM	ALTAVILLA MILICIA
AAT	ALTAVILLA-TAVERNELLE
AIS	ALTOPASCIO
ANV	ALVIANO
AEA	AMANTEA
AEM	AMBIVERE-MAPELLO
ALD	AMENDOLA
AAO	AMENDOLARA-ORIOLO
AIM	AMOROSI-MELIZZANO
AIF	ANAGNI-FIUGGI
ANC	ANCONA
AAR	ANCONA M.MA
AAE	ANCONA TORRETTE
ATT	ANCONETTA
ARO	ANDORA
ARI	ANGRI
ARL	ANGUILLARA
AEV	ANNONE VENETO
ANT	ANTIGNANO
ABV	ANTRODOCO-BORGO VELINO
AOO	ANTRODOCO CENTRO
AVS	ANVERSA-VILLALAGO-SCANNO
ADP	ANZANO DEL PARCO
AIZ	ANZIO
AOA	ANZIO COLONIA
ATS	AOSTA
AAU	AOSTA ISTITUTO
AVE	AOSTA VIALE EUROPA
AST	APICE-S. ARCANGELO-BONITO
ANP	APPIANO PROBA PETRONIA
ANR	APRICENA
AIL	APRILIA
AIN	AQUILONIA
AAD	ARAGONA-CALDARE
AIB	ARBIA
ACE	ARCE
ATI	ARCISATE
ALC	ARCOLA
ARC	ARCORE
ARD	ARDARA
AOM	ARDENNO-MASINO
RAR	ARDORE
AAP	ARENA PO
ARN	ARENZANO
AZO	AREZZO
ATN	ARGENTA
AOI	ARIANO IRPINO
NAR	ARONA
NRA	ARPINO
AAV	ARQUATA SCRIVIA
AUA	ARQUA
ALI	ARSOLI
RAN	ARTEGNA
AER	ARVIER
AEE	ASCEA
ANS	ASCIANO
AMO	ASCIANO-MONTE OLIVETO MAGGIORE
AIP	ASCOLI PICENO
IAA	ASCOLI SATRIANO
ALS	ASOLA
ANM	ASSEMINI
ASI	ASSISI
SAS	ASSO
TAS	ASTI
NAT	ATENA
ANL	ATTIGLIANO-BOMARZO
ATU	AUGUSTA
ATL	AULETTA
ALU	AULLA LUNIGIANA
AAG	AULLA LUNIGIANA
ANU	AURISINA
AVN	AVELLINO
ASV	AVERSA
NAV	AVEZZANO
NVA	AVIANO
VAN	AVIGLIANA
AOU	AVIGLIANO LUCANIA
AIV	AVIO
SAV	AVISE
ALV	AVOLA
BIC	BARI CENTRALE
BAC	BOLOGNA CENTRALE
BAP	BADIA POLESINE
BTO	BADOLATO
BIA	BAGHERIA
BLO	BAGNACAVALLO
BRA	BAGNARA
BAA	BAGNARIA ARSA
BCO	BAGNASCO
BDL	BAGNI DI LUCCA
BDT	BAGNI DI TIVOLI
BAT	BAGNOLI-AGNANO TERME
BII	BAGNOLI IRPINO
BOM	BAGNOLO MELLA
BDS	BAIANO DI SPOLETO
BRI	BALDICHIERI-TIGLIOLE
BTE	BALESTRATE
BNO	BALSORANO
BOR	BALVANO-RICIGLIANO
BLA	BALZOLA
BTT	BANDITO
BNN	BARAGIANO-RUOTI
BLL	BARANELLO
BLE	BARBIANELLO
BNA	BARBIANO
BSI	
BNL	BARCELLONA-CASTROREALE
BIH	BARDONECCHIA
BAG	BARGA-GALLICANO
BPM	BARI PALESE-MACCHIE
BPN	BARI PARCO NORD
BPS	BARI PARCO SUD
BSS	BARI S. SPIRITO
BSA	BARI S. ANDREA
BSG	BARI S. ANDREA
BTA	BARI TORRE A MARE
BTC	BARICETTA
BLI	BARILE
BTL	BARLETTA
BSN	BARONISSI
BIM	BASCHI-MONTECCHIO
BNI	BASILIANO
BDG	BASSANO DEL GRAPPA
BIT	BASSANO IN TEVERINA
BOO	BASSANO ROMANO
BIS	BASTIA
BAM	BASTIA MONDOVI
BAE	BATTAGLIA TERME
BIL	BATTIPAGLIA
BUM	BAULADU-MILIS
BNE	BAVENO
BNZ	BAZZANA
BRD	BEAULARD
BFI	BEFFI
BTN	BEINETTE
BSO	BELGIOIOSO
BTR	BELGIRATE
BAO	BELLA-MURO
BTM	BELLANO-TARTAVALLE TERME
BER	BELLANTE-RIPATTONE
BIR	BELLARIA
BTS	BELLAVISTA
BGO	BELLINZAGO
BOS	BELLISIO SOLFARE
BNU	BELLUNO
BEC	BELMONTE CALABRO
BEM	BELVEDERE MARITTIMO
BTV	BENEVENTO
BAN	BENEVENTO ARCO TRAIANO
BPR	BENEVENTO PORTA RUFINA
BET	BERCETO
BDA	BERCHIDDA
BCC	BERGAMASCO
BMO	BERGAMO
BDD	BERNALDA
BNS	BESANA
TBE	BESNATE
BZO	BESOZZO
BAZ	BEURA-CARDEZZA
BRR	BEVERA
BUA	BEVILACQUA
BIG	BIAGIONI LAGACCI
BCN	BIANCO
BZE	BIANZE'
BIN	BIANZONE
BLP	BIASSONO-LESMO
BNB	BIBIANA
BCA	BICOCCA
BAV	BIELLA-CHIAVAZZA
BSP	BIELLA S. PAOLO
BCR	BIFORCO
BSM	FIRENZE S. MARCO VECCHIO
BIE	BISCEGLIE
BNG	BISTAGNO
BOV	BISUSCHIO-VIGGIU'
BPD	BITETTO-PALO DEL COLLE
BOD	BIVIO D'AURISINA
BAR	BOCCIA AL MAURO
BCS	BOGLIASCO
BON	BOIANO
BRE	BOLGHERI
BBP	BOLOGNA BORGO PANIGALE
BCV	BOLOGNA CENTRALE
BAL	BOLOGNA CORTICELLA
BAF	BOLOGNA FICO-EW
BAI	BOLOGNA MAZZINI
AAB	
BSR	BOLOGNA S. RUFFILLO
NBO	BOLZANO BOZEN
BOE	BOLZANO NOVARESE
BOU	BOLZANO SUD BOZEN SUD
BLS	BONASSOLA
BSC	BONEFRO-S. CROCE
BRO	BONFERRARO
BVA	BONORVA
BRH	BORDIGHERA
BTH	BORGHETTO SULL'ADIGE
BOP	BORGHETTO PARMENSE
BST	BORGHETTO S. SPIRITO
BOI	BORGIO-VEREZZI
BGG	BORGO
BAB	BORGO A BUGGIANO
BOA	BORGO A MOZZANO
BFP	BORGO FORNARI PER VOLTAGGIO
BOL	BORGO LAVEZZARO
BEO	BORGO REVEL
BSL	BORGO S. LORENZO
BSE	BORGO S. LORENZO-RIMORELLI
BAS	BORGO S. MARTINO
BSD	BORGO S. DALMAZZO
BOT	BORGO TICINO
BVD	BORGO VAL DI TARO
BVC	BORGO VALSUGANA CENTRO
BVE	BORGO VALSUGANA EST
BOC	BORGO VERCELLI
BTF	BORGOFORTE
BCF	BORGOFRANCO
BDO	BORGO LOMBARDO
BRN	BORGOMANERO
BNR	BORGONE
BTG	BORGORATTO
BIO	BORGOSESIA
RBO	BORORE
SBN	BOSCHI S. ANNA
OBE	BOSCO REDOLE
BLR	BOSCOREALE
BLC	BOTRICELLO
ZBB	BOVA MARINA
BNV	BOVALINO
OEB	BOVINO-DELICETO
NOB	BOVOLONE
BLZ	BOZZOLO
RBR	BRA
BNC	BRACCIANO
NBR	BRAGNO
NRB	BRANCALEONE
BZZ	BRANDIZZO
BSY	BREIL-SUR-ROYA
ALB	BRENNA-ALZATE
RRB	BRENNERO BRENNER
IBR	BRESCIA
ABR	BRESSANA ARGINE
ABO	BRESSANA BOTTARONE
RBN	BRESSANONE BRIXEN
BCI	BRIATICO
IRB	BRICHERASIO
BRS	BRINDISI
BDM	BRINDISI DI MONTAGNA
IBA	BRINDISI M.MA
RNB	BRIONA
BLH	BRISIGHELLA
BOF	BROLO-FICARRA
YZZ	BRONI
BLN	BRONZOLO BRANZOLL
BRL	BROZOLO
BCU	BRUNICO BRUNECK
YZB	BRUNO
BLU	BRUZOLO DI SUSA
OBS	BUCCINO-S. GREGORIO MAGNO
BUN	BUCINE
OBA	BUDOIA-POLCENIGO
BRG	BUGNARA
BTU	BUONCONVENTO
BLF	BUONFORNELLO
BZN	BURONZO
BUL	BUSALLA
BUC	BUSCA
BLM	BUSCHE-LENTIAI-MEL
BUT	BUSSETO
BSU	BUSSI
NBU	BUSSOLENO
BOZ	BUSTO ARSIZIO
BVV	BUTTAFAVA
BRT	BUTTAPIETRA
BIU	BUTTRIO
CEO	CADEO
CRI	CAGLIARI
CIE	CAGLIARI-ELMAS
COM	CAIRO MONTENOTTE
CAS	CALA SABINA
CPC	CALALZO-PIEVE DI CADORE-CORTINA
CNA	CALAMANDRANA
CNO	CALATABIANO
CMI	CALATAFIMI
CCA	CALCERANICA
CNN	CALCIANO
CIO	CALCIO
CDE	CALDE
CRO	CALDIERO
CZO	CALDONAZZO
CNZ	CALENZANO
CIP	CALITRI-PESCOPAGANO
CEE	CALOLZIOCORTE-OLGINATE
CTI	CALOPEZZATI
CNE	CALTAGIRONE
CAC	CALTANISSETTA CENTRALE
CAX	CALTANISSETTA XIRBI
CGA	CALTIGNAGA
CCO	CALUSCO
CSO	CALUSO
CNS	CALVISANO
CLC	CAMAIORE LIDO-CAPEZZANO
CNI	CAMBIANO
COS	CAMBIANO-SANTENA
CSG	CAMMARATA-S. GIOVANNI GEMINI
COL	CAMNAGO-LENTATE
CSF	CAMOGLI-S. FRUTTUOSO
CSP	CAMPAGNA-SERRE-PERSANO
CLO	CAMPELLO SUL CLITUNNO
CAM	CAMPIGLIA MARITTIMA
CDC	CAMPO DI CARNE
CDG	CAMPO DI GIOVE
CDA	CAMPO DI GIOVE MONTE MAIELLA
CDN	CAMPO DI NUSCO
CDT	CAMPO DI TRENS FREIENFELD
CSS	CAMPOBASSO
CDM	CAMPOBELLO DI MAZARA
COR	CAMPOBELLO-RAVANUSA
CGO	CAMPODARSEGO
CCE	CAMPOFELICE
CCC	CAMPOFRANCO
CRR	CAMPOLATTARO
CNL	CAMPOLEONE
COI	CAMPOLIETO-MONACILIONE
CEM	CAMPO LIGURE-MASONE
CRE	CAMPOMAGGIORE-PIETRAPERTOSA
CNR	CAMPOMARINO
CLA	CAMPOMELA
CII	CAMPOMIGLIAIO
CSL	CAMPORA-S. GIOVANNI-SERRA AIELLO
CNG	CAMPORGIANO
CRP	CAMPOSAMPIERO
CTO	CAMPOSANTO
CAA	CAMUCIA-CORTONA
CRA	CANCELLIERA
CLL	CANCELLO
COA	CANCELLO-ARNONE
CLE	CANDELA-S. AGATA DI PUGLIA
CLD	CANDELO
CAE	CANDIA CANAVESE
CAL	CANDIA LOMELLINA
CDD	CANDIDA
CLI	CANDIOLO
CAO	CANDOGLIA-ORNAVASSO
CTE	CANEGRATE
CLN	CANELLI
CRT	CANETRA
CTT	CANICATTI'
CGG	CANICATTI'
CRN	CANNARA
CDB	CANNE DELLA BATTAGLIA
COO	CANNETO SULL'OGLIO
CDP	CANOSA DI PUGLIA
CDS	CANTALUPO DEL SANNIO-MACCHIAGODENA
CTU	CANTU
CUC	CANTU'-CERMENATE
CSR	CAORSO
COE	CAPACCIO-ROCCADASPIDE
CCI	CAPACI
CIB	CAPALBIO
CLP	CAPANNELLE
CLR	CAPISTRELLO
COB	CAPO BONIFATI
CDO	CAPO D'ORLANDO-NASO
COT	CAPO SPARTIVENTO
CPF	CAPODACQUA-PIEVE FANONICA
CEN	CAPPELLE-MAGLIANO
CBA	CAPRALBA
CCN	CAPRANICA-SUTRI
LCA	CAPRAROLA
CAV	CAPRIATI A VOLTURNO
LAC	CAPRIOLO
CVA	CAPRIVA
CUA	CAPUA
CEC	CARATE-CALO'
CIG	CARAVAGGIO
CNB	CARBONA
CAI	CARBONARA SCRIVIA
CAU	CARBONIA SERBARIU
COZ	PALERMO CARDILLO-ZEN
CNT	CARENTINO
CTA	CARIATI
CTM	CARIMATE
CAN	CARINI
CTC	CARINI-TORRE CIACHEA
CIS	CARISIO
CLG	CARMAGNOLA
CDR	CARMIGNANO DI BRENTA
CEU	CARNATE-USMATE
CIA	CARNIA
CIN	CARONIA
CNV	CAROVIGNO
CIR	CAROVILLI-ROCCASICURA
CNP	CARPANE'-VALSTAGNA
CPI	CARPI
OCE	CARPIGNANO SESIA
NCA	CARPINONE
CAZ	CARRARA-AVENZA
CON	CARRITO-ORTONA
CBB	CARRUBA
CUN	CARRU'-CLAVESANA
CLS	CARSOLI
CCB	CASABIANCA
CAG	CASACALENDA-GUARDIALFIERA
CLB	CASAL SABINI
COP	CASALBORDINO-POLLUTRI
CNU	CASALBUONO
NAC	CASALBUTTANO
CET	CASALE MONFERRATO
CEP	CASALE POPOLO
CED	CASALECCHIO DI RENO
COG	CASALECCHIO GARIBALDI
CIL	CASALEGGIO
COV	CASALETTO VAPRIO
CRG	CASALMAGGIORE
CVO	CASALNUOVO DI NAPOLI
CGN	CASALPUSTERLENGO
CSA	CASARSA
CNC	CASCINA
CTR	CASERTA
DCE	CASINO DI TERRA
OCO	CASLETTO-ROGENO
CES	CASORATE SEMPIONE
ICA	CASORIA-AFRAGOLA
NCU	CASSAGO-NIBIONNO-BULCIAGO
OCL	CASSANO ALLO JONIO
COD	CASSANO D'ADDA
OCR	CASSANO IRPINO
ACN	CASSINE
ZNA	CASSINO
ACL	CASSOLA
CRS	CASTAGNARO
COC	CASTAGNETO CARDUCCI-DONORATICO
YZA	CASTAGNO
CDL	CASTAGNOLE DELLE LANZE
CIT	CASTEGGIO
CBD	CASTEL BAGNOLO DI ORTE
CAD	CASTEL DI SANGRO
ZLA	CASTEL D'ARIO
CLF	CASTEL GANDOLFO
YLZ	CASTEL LAGOPESOLE
CLM	CASTEL MADAMA
CSE	CASTEL S. ANGELO
CST	CASTEL S. GIORGIO-ROCCAPIEMONTE
CSI	CASTEL S. GIOVANNI
CSM	CASTEL S. PIETRO TERME
CLT	CASTELBELLO KASTELBELL
CSN	CASTELBOLOGNESE-RIOLO TERME
YNZ	CASTELBUONO
CIC	CASTELDACCIA
CND	CASTELDARNE EHRENBURG
YLA	CASTELDEBOLE
CTF	CASTELFERRETTI-FALCONARA AEROPORTO
CNF	CASTELFIORENTINO
CCR	CASTELFRANCI
OEC	CASTELFRANCO DI SOPRA
ECO	CASTELFRANCO VENETO
CFO	CASTELGUELFO
OCA	CASTELLALTO-CANZANO
CDF	CASTELLAMMARE DEL GOLFO
CDI	CASTELLAMMARE DI STABIA
CAR	CASTELLANETA MARINA
OAC	CASTELLAZZO-CASALCERMELLI
YNA	CASTELLEONE
COU	CASTELLETTO BUSCA
OCI	CASTELLETTO TICINO
CAH	CASTELLINA IN CHIANTI-MONTERIGGIONI
CAT	CASTELLINA M.MA
ACO	CASTELLINO TANARO
DCO	CASTELLO DI GODEGO
ZOA	CASTELLO D'ANNONE
CIH	CASTELLUCCHIO
CRF	CASTELL'ALFERO
CRM	CASTEL MAGGIORE
CVV	CASTELNUOVO BELBO
EOC	CASTELNUOVO BELBO
ZCB	CASTELNUOVO BERARDENGA
DCA	CASTELNUOVO DI GARFAGNANA
CUO	CASTELPLANIO-CUPRAMONTANA
YOZ	CASTELRAIMONDO-CAMERINO
SCA	CASTELROSSO
CAP	CASTELSPINA-PORTANOVA
YOA	CASTELVECCHIO PASCOLI
CRV	CASTELVETERE
ZYY	CASTELVETRANO
CRL	CASTELVETRO
DAC	CASTIGLIONE DEL LAGO
NCI	CASTIGLION FIORENTINO
XZZ	CASTIGLIONCELLO
CEI	CASTIGLIONE COSENTINO
CID	CASTIGLIONE DI SICILIA
CIV	CASTIGLIONE IN TEVERINA
CEA	CASTIONE ANDEVENNO
CDH	CASTIONE DEI MARCHESI
COF	CASTRO-POFI-VALLECORSA
XZY	CASTRONNO
CAQ	CATANIA ACQUICELLA
ECA	CATANIA CENTRALE
ACG	CATANIA OGNINA
CRZ	CATANZARO
OIC	CATANZARO LIDO
CVU	CATENANUOVA-CENTURIPE
CSC	CATTOLICA-S. GIOVANNI-GABICCE
CIU	CAULONIA
CAB	CAVA CARBONARA
DCI	CAVA DE' TIRRENI
ZII	CAVA CARBONARA
ACI	CAVA TIGOZZI
ORC	CAVAGNOLO-BRUSASCO
ICO	CAVALLEGGERI AOSTA
RCA	CAVALLERMAGGIORE
YZI	CAVANELLA D'ADIGE
ZNN	CAVANELLA PO
COJ	CAVARIA-OGGIONA-IERAGO
CLZ	CAVAZZALE
CVI	CAVI
DOC	CA' DI BOSCHETTI
NCE	CECCANO
CNH	CECCHINA
NEC	CECINA
CLU	CEFALU
ICE	CEGGIA
OCV	CELANO-OVINDOLI
CEL	CELLE
CBR	CELLE BULGHERIA-ROCCAGLORIOSA
IEC	CENGIO
LCE	CENTALLO
LEC	CENTOLA-PALINURO MARINA DI CAMEROTA
XYZ	CEPRANO-FALVATERRA
CCS	CERCENASCO
ECI	CERCHIO
ECN	CERCINA
DEC	CERDA
CER	CEREA
ENC	CEREGNANO
ECL	CERIALE
ELC	CERIGNOLA CAMPAGNA
YCZ	CERNUSCO-MERATE
YCB	CERRETO D'ESI
ECD	CERTALDO
CDV	CERTOSA DI PAVIA
RCE	CERVARO
CMM	CERVIA-MILANO MARITTIMA
AGC	CERVIGNANO-AQUILEIA-GRADO
CCG	CERVIGNASCO
CSB	
OCD	CESANO DI ROMA
SCE	CESE
ZOO	CESENA
CCT	CESENATICO
REC	CETRARO
CVE	CEVA
CVB	CHAMBAVE
CSV	CHATILLON-SAINT VINCENT
CCH	CHERASCO
ECE	CHIANCHE-CEPPALONI
CLV	CHIARAVALLE
CRH	CHIARI
CHN	CHIARONE
CSH	CHIASSO
CHR	CHIAVARI
NCH	CHIAVENNA
RCH	CHIERI
CTH	CHIETI
EIC	CHIEUTI-SERRACAPRIOLA
OOC	CHIGNOLO PO
CHI	CHIOGGIA
CTN	CHIOMONTE
CZA	CHIRIALZA
NHC	CHIUDUNO
CRU	CHIURO
CSU	CHIUSA KLAUSEN
YZN	CHIUSANO-COSSOMBRATO
TCC	CHIUSI-CHIANCIANO TERME
CHS	CHIVASSO
CNM	CIAMPINO
ZEI	CIARDES TSCHARS
YZO	CINISI-TERRASINI
CAJ	CIRELLA-MAJERA'
RCI	CIRO'
CCM	CISANO-CAPRINO BERGAMASCO
CRD	CISMON DEL GRAPPA
ACD	CISTERNA DI LATINA
NIC	CISTERNINO
YIZ	CITERNA TARO
LCI	CITTADELLA
LIC	CITTADUCALE
DIC	CITTA' DELLA PIEVE
CTV	CIVATE
YII	CIVITA CASTELLANA-MAGLIANO
ODC	CIVITA D'ANTINO-MORINO
XYY	CIVITANOVA MARCHE-MONTEGRANARO
ICI	CIVITAVECCHIA
CMA	CIVITAVECCHIA PORTO
CVD	CIVITAVECCHIA VIALE DELLA VITTORIA
ZYI	CIVITELLA-PAGANICO
YNN	CIVITELLA ROVETO
CRX	
SCL	CLASSE
IOC	COCCAGLIO
TCO	COCCONATO
LCO	COCULLO
NCO	CODOGNO
LOC	CODOLA
CPO	CODROIPO
CTL	COGOLETO
ZYA	COLDRANO-MARTELLO GOLDRAIN-MARTELL
CCL	COLICO
ECS	COLLE ISARCO GOSSENSASS
EAC	COLLE MATTIA
CVS	COLLE VAL D'ELSA
ZYN	COLLECCHIO
SAC	COLLEFERRO-SEGNI-PALIANO
NOC	COLLEGNO
CTS	COLLESALVETTI
XZN	COLLEVECCHIO-POGGIO SOMMAVILLA
XYN	COLLI DI MONTE BOVE
OCN	COLOGNE
ONC	COLORNO
CGI	COMIGNAGO
SCO	COMISO
SCI	COMO S. GIOVANNI
CBI	COMPIOBBI
RCO	CONDOFURI
CVN	CONDOVE-CHIUSA S. MICHELE
ZNY	CONEGLIANO
OCC	CONSELICE
XNZ	CONTEA-LONDA
SOC	CONTESSE
XNY	CONTIGLIANO
CIM	CONTURSI TERME
SCT	CORBETTA-S. STEFANO TICINO
CZI	CORBEZZI
XNN	CORCHIANO
ZYB	CORDOVADO-SESTO
XZA	CORIGLIANO CALABRO
ZXX	CORMONS
YZX	CORNIGLIA
YXZ	CORNINO
CDU	CORNUDA
YXX	CORRIDONIA-MOGLIANO
WZZ	CORSANO
WZY	CORSICO
WYZ	CORTEOLONA
CZZ	COSENZA
ROC	COSIO-TRAONA
TOC	COSSATO
OCT	COSTA
XZI	COSTA MASNAGA
C(D	COSTIGLIOLE (MOTTA DI)
ZEA	COSTIGLIOLE D'ASTI
CEZ	COSTIGLIOLE SALUZZO
OLC	COTIGNOLA
WYY	COTILIA
CZE	COZZE
ZCO	COZZO
CME	CREMA
NCR	CREMONA
NRC	CRESCENTINO
CAF	CRESSA-FONTANETO
CRC	CREVALCORE
ICR	CROCICCHIE
RCN	CROPANI
RNC	CROTONE
LCR	CRUCOLI
CGC	CUCCIAGO
CUE	CUNEO
XZB	CUNEO GESSO
ZBC	CUNICO-SCANDELUZZA
NUC	CUPONE
CMT	CUPRAMARITTIMA
CUI	CUREGGIO
UCN	CUSANO
CUR	CUTRO
CGZ	CUZZAGO
DNU	DECIMOMANNU
DGO	DEGO
DAM	DEIVA MARINA
DIO	DELEBIO
DBY	DERBY
DII	DERVIO
DNO	DESENZANO DEL GARDA-SIRMIONE
DIS	DESIO
DEB	DIAMANTE-BUONVICINO
DOM	
DNN	DICOMANO
DOP	DIECIMO-PESCAGLIA
DNI	DITTAINO
DCC	DOBBIACO TOBLACH
DLO	DOLO
DRA	DOMEGLIARA-S. AMBROGIO
DLA	DOMODOSSOLA
DNA	DONNA
DTA	DONNAFUGATA
DAZ	DONNAZ
DIR	DORIO
DTO	DORMELLETTO
DOE	DORMELLETTO PAESE
DNB	DOSSOBUONO
DRO	DRONERO
DUN	DUBINO
DLE	DUEVILLE
DID	
ELI	EBOLI
EAN	ECA NASAGO
ETE	ECCELLENTE
EAT	EGNA-TERMENO NEUMARKT-TRAMIN
EIA	EGNAZIA
EAO	ELLERA-CORCIANO
ELL	EMPOLI
EAS	ENAS
ENA	ENNA
EIT	EQUI TERME
ETT	ESTE
EES	EXILLES
FSM	FIRENZE S. M. NOVELLA
FNO	FABRIANO
FCM	FABRIANO-CA' MAIANO
FDR	FABRICA DI ROMA
FOF	FABRO-FICULLE
FZA	FAENZA
FNA	FAE'-FORTOGNA
FRE	FAGARE
FOC	FAGNANO-CAMPANA
FMC	FALCIANO-MONDRAGONE-CARINOLA
FRA	FALCONARA
FAM	FALCONARA MARITTIMA
FAS	FALCONARA STADIO
FNE	FALCONE
FNN	FALERNA
FAC	FANNA-CAVASSO
FAN	FANO
FLO	FANZOLO
FRR	FARA
FAA	FARA SABINA-MONTELIBRETTI
FNI	FARIGLIANO
FNS	FASANO
FAL	FAUGLIA-LORENZANA
FNZ	FAVAZZINA
FCO	PALERMO IMPERATORE FEDERICO
FSA	FELEGARA-S. ANDREA BAGNI
FNL	FELIZZANO
FRT	FELTRE
FOS	FERENTINO-SUPINO
FAP	FEROLETO ANTICO-PIANOPOLI
FND	FERRANDINA-SCALO MATERA
FIA	FERRANIA
FER	FERRARA
FAI	FERRERA LOMELLINA
FNU	FERRUZZANO
FIR	FIRENZE ROVEZZANO
FIN	FIDENE
FZZ	FIDENZA
FRI	PALERMO FIERA
FEC	FIESOLE-CALDINE
FEV	FIGLINE VALDARNO
FRL	FILATTIERA
NFI	FILDIDONNA
NIF	FILIANO
FLM	FINALE LIGURE MARINA
FLA	FIORENZUOLA
FCE	FIRENZE CAMPO DI MARTE
FEO	FIRENZE CASTELLO
FEI	FIRENZE RIFREDI
FES	FIRENZE STATUTO
FNC	FISCIANO
FOB	FIUMEFREDDO BRUZIO
FDS	FIUMEFREDDO SICILIA
FTE	FIUMELATTE
FTO	FIUMETORTO
FOA	FIUMICINO AEROPORTO
FOG	FIVIZZANO-GASSANO
FRS	FIVIZZANO-ROMETTA-SOLIERA
FII	FOGGIA
FNG	FOLIGNO
FCA	FOLLONICA
FIS	FONDI-SPERLONGA
FDA	FONTANAFREDDA
FOP	FONTANETTO PO
FVA	FONTANIVA
FNB	FONTEBUONA
FIO	FONTECCHIO
FZN	FORENZA
FBA	FORGARIA-BAGNI ANDUINS
FLI	FORLIMPOPOLI-BERTINORO
FLL	FORLI
FAG	FORMIA-GAETA
FDB	FORNACI DI BARGA
FVO	FORNOVO
FDM	FORTE DEI MARMI-SERAVEZZA-QUERCETA
FZE	FORTEZZA FRANZENSFESTE
FAR	FOSCIANDORA-CESERANA
FIE	FOSSACESIA-TORINO DI SANGRO
FTD	FOSSACESIA-TORINO DI SANGRO
FDP	FOSSALTA DI PIAVE
FDO	
FON	FOSSANO
FDV	FOSSATO DI VICO-GUBBIO
FOM	FRAGNETO MONFORTE
FRU	FRAMURA
FLV	FRANCAVILLA DI SICILIA
FAE	FRANCAVILLA AL MARE
FAF	FRANCAVILLA ANGITOLA-FILADELFIA
FAT	FRANCAVILLA FONTANA
FIC	PALERMO FRANCIA
FTI	FRASCATI
FTA	FRASSO TELESINO-DUGENTA
FTT	FRATTA
FRO	FRATTAMAGGIORE-GRUMO
FLR	FRATTAROLO
FTR	FRATTE
FET	FRATTE CENTRO
FVC	FRATTE - VILLA COMUNALE
FNR	FROSINONE
FOO	FRUGAROLO-BOSCOMARENGO
FOR	FUNO CENTERGROSS
FCI	FURCI
FDD	FUSCALDO
GPP	GENOVA PIAZZA PRINCIPE
GAG	GABELLA GRANDE
GGI	GAGGI
GNO	GAGGIANO
GIO	
GLE	GAGLIOLE
GLA	GAIBANELLA
GNA	GAIFANA
GTI	GALATI
GDO	GALDO
GTE	GALLARATE
GEB	GALLESE-BASSANELLO
GIT	GALLESE TEVERINA
GRA	GALLIERA
GVT	GALLIERA VENETA-TOMBOLO
GRO	GAMALERO
GLL	GAMBETTOLA
GDD	GAMBOLO'-REMONDO'
GNN	GARBAGNA
GII	GARESSIO
GCO	GARLASCO
GAM	GATTEO A MARE
GRR	GATTINARA
GNR	GAVORRANO
GSM	GAZZADA-SCHIANNO-MORAZZONE
GDB	GAZZO DI BIGARELLO
GPS	GAZZO-PIEVE S. GIACOMO
GEL	GELA
GLI	GEMELLI
GDF	GEMONA DEL FRIULI
GSV	GENGA-S. VITTORE TERME
GAA	GENOVA ACQUASANTA
GAB	GENOVA BOLZANETO
GAI	GENOVA BORZOLI
GAE	GENOVA BRIGNOLE
GAC	GENOVA CORNIGLIANO
GCD	GENOVA COSTA DI SESTRI PONENTE
GAR	GENOVA GRANARA
GMS	GENOVA MARITTIMA
GAN	GENOVA NERVI
GPA	GENOVA PIAZZA PRINCIPE
GAP	GENOVA PEGLI
GAO	GENOVA PONTEDECIMO
AGR	GENOVA PRA
GQD	GENOVA QUARTO DEI MILLE
GQA	GENOVA QUINTO AL MARE
GAL	GENOVA RIVAROLO
GSB	GENOVA S.BIAGIO
GAS	GENOVA SAMPIERDARENA
GSP	GENOVA SESTRI PONENTE AEROPORTO
GAU	GENOVA STURLA
GAV	GENOVA VESIMA
GVD	GENOVA VIA DI FRANCIA
GAT	GENOVA VOLTRI
GDI	GHEDI
GME	GHEMME
GGO	GHISLARENGO
GOC	GHIVIZZANO-COREGLIA
GRY	PALERMO GIACHERY
GRI	GIAMPILIERI
GLO	GIAROLE
GER	GIARRE-RIPOSTO
GVE	GIAVE
GSA	GINOSA
GDC	GIOIA DEL COLLE
YOO	GIOIA TAURO
GAJ	GIOIOSA JONICA
ZYO	GIOIOSA MAREA
GZO	GIOVINAZZO
GOQ	GIUGLIANO-QUALIANO
GVA	GIULIANOVA
GNC	GIUNCANO
GCC	GIUNCARICO
GAD	GIZZERIA LIDO
GIE	GLORIE
GOD	GODO
GDA	GOLE DI ALCANTARA
GOA	GOLFO ARANCI
GEA	GONZAGA-REGGIOLO
AGO	GORGO AL MONTICANO
GOS	GORIANO SICOLI
AGE	GORIZIA CENTRALE
GNZ	GOZZANO
GNG	GRAGNANO
GLN	GRAGNOLA
GLH	GRAMMICHELE
GLR	GRANAIOLO
GRL	GRANAROLO FAENTINO
GTT	GRANITI
GNS	GRASSANO-GARAGUSO-TRICARICO
AOG	GRAVELLONA TOCE
GIP	GRAVINA IN PUGLIA
GIC	GRECCIO
GNI	GRICIGNANO-TEVEROLA
GRN	GRIGNANO
GCS	GRIGNASCO
NGR	GRIGNO
GDZ	GRISIGNANO DI ZOCCO
GSI	GRISOLIA-SANTA MARIA
NRG	GRIZZANA
GOI	GROPELLO CAIROLI
GTO	GROSSETO
GIL	GROTTAGLIE
GRE	GROTTAMMARE
GTR	GROTTE
GSS	GROTTE S. STEFANO
GDM	GRUMELLO DEL MONTE
GOL	GRUMO APPULA
GOT	GUALDO TADINO
GLV	GUARDAVALLE
GMA	GUARDIA-MANGANO-S. VENERINA
GPT	GUARDIA PIEMONTESE TERME
GIA	GUARDIAREGIA
GMO	GUIDONIA-MONTECELIO-S. ANGELO
HEB	HONE-BARD
IAM	IGEA MARINA
IAS	IGLESIAS
ICB	LE CURE
ICT	SALVIATI
ILN	IL NETO
ILA	IMOLA
IAO	
ISA	INCISA
IAN	INCISA SCAPACCINO
ITA	INCORONATA
IRE	
IOO	INDUNO OLONA
IDO	IPOGEO DEGLI OTTAVI
IIA	ISERNIA
ICU	ISOLA CAPO RIZZUTO
IDC	ISOLA DEL CANTONE
IDS	ISOLA DELLA SCALA
IDF	ISOLA DELLE FEMMINE
IAD	ISOLA D'ASTI
IAL	ISOLA LIRI
ISG	ISOLETTA-S. GIOVANNI INCARICO
ICC	ISPICA
IRA	ISPRA
INA	ISTRANA
IRI	ITRI
IEA	IVREA
JSI	JESI
JLO	JOPPOLO
LAF	LA FIORA
LAG	LA GIUSTINIANA
LAS	LA SALLE
LSC	LA SPEZIA CENTRALE
LSM	LA SPEZIA MIGLIARINA
LAA	LA STORTA-FORMELLO
LOM	LABRO-MOGGIO
LES	LACES LATSCH
LII	LADISPOLI-CERVETERI
LRO	LAGONEGRO
LIA	LAIGUEGLIA
LEE	LAIVES LEIFERS
LMA	LAMA
LDR	LAMA DI RENO
LIN	LAMBRINIA
LTC	LAMEZIA TERME CENTRALE
LTN	LAMEZIA TERME-NICASTRO
LTS	LAMEZIA TERME-SAMBIASE
LAP	LANA-POSTAL LANA-BURGSTALL
LGO	LANCENIGO
LIO	LANUVIO
LAI	LANZARA-FIMIANI
LNO	LARINO
LSA	LASA LAAS
LRI	LASCARI
LNA	LATERINA
LNN	LATIANO
LNI	LATINA
LLB	LATISANA-LIGNANO-BIBIONE
LNR	LAURIANO
LNG	LAVAGNA
LOO	LAVENO-MOMBELLO
LLA	LAVEZZOLA
LNV	LAVINO
LIS	LAVIS
LTE	LAVORATE
LEP	LE PIAGGE
LCC	LECCE
ZLL	LECCO
LOI	LECCO MAGGIANICO
LOE	LEGGIUNO-MONVALLE
LGG	LEGNAGO
LNE	LEGNANO
LRA	LENDINARA
LNT	LENTINI
LID	LENTINI DIRAMAZIONE
LSS	LEONESSA
LEO	LEONFORTE-PIRATO
LAB	LERCARA BASSA
LEN	LERINO
LSE	LESA
LNS	LESEGNO
LMO	LESMO
LNJ	LETOJANNI
LDA	LEVADA
LTO	LEVANTO
LCV	LEVICO TERME
LTA	LICATA
LDC	LIDO DI CLASSE-LIDO DI SAVIO
LDL	LIDO DI LAVINIO
NLI	LIERNA
LNM	LIMONE
NIL	LIONI
LVD	LIONI-VALLE DELLE VITI
LRR	LISIERA
LON	LISON
LEM	LISSONE-MUGGIO'
LOL	LIVORNO CENTRALE
LOF	LIVORNO FERRARIS
NLO	LOANO
LET	LOCATE TRIULZI
LRC	LOCRI
LDI	LODI
LLO	LOMELLO
LTT	LONATO
LEZ	LONGARONE-ZOLDO
LDD	LONGOBARDI
LGI	LONIGO
LER	LOREO
LTR	LORETO
LCU	LUCCA
LGU	LUGO
LNU	LUINO
LCN	LUMIGNACCO
LLL	LUNGAVILLA
LZA	LUNGHEZZA
LUN	LUOGOSANO-S. MANGO SUL CALORE
LSG	LUSERNA SAN GIOVANNI
LLI	L'AQUILA
MOC	MILANO CENTRALE
MSE	MACCARESE-FREGENE
MTA	MACERATA
MAF	MACERATA FONTESCODELLA
MOS	MACHERIO-SOVICO
MOA	MACHERIO-CANONICA
MER	MACOMER
MNE	MADDALENE
MII	MADDALONI INFERIORE
MIS	MADDALONI SUPERIORE
MNO	MADIGNANO
MDP	MADONNA DEL PIANO
MDE	MADONNA DEL PILONE
MDS	MADONNA DELLA SCALA
MDC	MADONNA DI CASTRO
MDM	MAERNE DI MARTELLAGO
MTT	MAGENTA
MNN	MAGIONE
MNA	MAGLIANA
MCM	MAGLIANO-CRAVA-MOROZZO
MEC	MAGRE'-CORTACCIA MARGREID-KURTATSCH
MNJ	MAJANO
MEO	MALEO
MSV	MALLES VENOSTA MALS
MDT	MALTIGNANO
MLA	MANAROLA
MON	MANDATORICCIO-CAMPANA
MAS	VALLE DELL'ANIENE-MANDELA-SAMBUCI
MDL	MANDELLO DEL LARIO
MIO	MANERBIO
MIA	MANFREDONIA
MGO	MANIAGO
MLO	MANOPPELLO
MTN	MANTA
MVA	MANTOVA
MAE	MANTOVA FRASSINE
MNZ	MANZANO
MCO	MANZIANA-CANALE MONTERANO
MNR	MARANO VICENTINO
MOT	MARANO TICINO
MEA	MARATEA
MSA	MARAUSA
MIR	MARCARIA
MVO	MARCELLINA-VERBICARO-ORSOMARSO
MAP	MARCELLINA-PALOMBARA
MRA	MARCELLINARA
MSS	MARCIANISE
MIN	MARCONIA
MRO	MARECHIARO
MTI	MARGARITA
MDO	S. 
MOE	MARIANO COMENSE
MLI	MARIANOPOLI
MNI	MARIGLIANO
MDI	MARINA DI CERVETERI
MDA	MARINA DI MARATEA
MDZ	MARINA DI S. LORENZO
MLL	MARINELLA
MAN	MARINO LAZIALE
MDN	MARINO DEL TRONTO-FOLIGNANO
MGG	MARLENGO MARLING
MRE	MARMORE
MAM	MAROTTA-MONDOLFO
MDD	MARRADI-PALAZZUOLO SUL SENIO
MTE	MARRUBIU-TERRALBA-ARBOREA
MLS	MARSALA
MTO	MARZABOTTO
MMI	MARZAMEMI
MCA	MARZOCCA
MLC	MASCALI
MIH	MASCHIO
MAC	MASSA CENTRO
MRR	MASSAFRA
MDR	MASSALOMBARDA
MAB	MASSAROSA-BOZZANO
MCC	MATELICA
MEM	MATRICE-MONTAGANO-S.G. IN GALDO
MDV	MAZARA DEL VALLO
MED	MEDE
MNS	MEDESANO
MNU	MEDUNO
MEN	MEINA
MOM	MELANO-MARISCHIO
MLE	MELE
MNG	MELEGNANO
MFI	MELFI
MAD	MELITO DI PORTO SALVO
MZO	MELZO
MEL	MEOLO
NME	MERANA
NEM	MERANO MERAN
MMB	MERANO-MAIA BASSA MERAN-UNTERMAIS
MSO	MERCATO S. SEVERINO
MCS	MERCENASCO
MZZ	MERGOZZO
EMN	MERONE
ENM	MESAGNE
MAL	MESSINA CENTRALE
MAA	MESSINA MARITTIMA
MNT	MESTRINO
MTP	METAPONTO
MID	MEZZANI-RONDANI
ZMM	MEZZANO
MNC	MEZZOCORONA
MPG	MILANO PORTA GARIBALDI
MPA	MILANO PORTA GENOVA
MGE	MIGNANEGO
MDG	MIGNANO MONTE LUNGO
MBF	MILANO NORD BOVISA
MOO	MILANO CERTOSA
MOD	MILANO DATEO
MGP	MILANO GRECO PIRELLI
MOL	MILANO LAMBRATE
MOI	MILANO LANCETTI
MPI	MILANO PORTA GARIBALDI
MPR	MILANO PORTA ROMANA
MPV	MILANO PORTA VITTORIA
MOR	MILANO ROGOREDO
OMO	MILANO ROMOLO
MSC	MILANO S. CRISTOFORO
MOV	MILANO PORTA VENEZIA
MZA	MILAZZO
MTL	MILETO
MLT	MILITELLO
MLM	
MEE	MINEO
MOG	MINERVINO MURGE
NMI	MINTURNO-SCAURI
MPC	MINUCCIANO-PIEVE-CASOLA
MAO	MIRA-MIRANO
OME	MIRADOLO TERME
MLD	MIRANDOLA
OMR	MIRTO-CROSIA
OMD	MISANO ADRIATICO
MND	MODENA
MCI	MODICA
OMI	MODUGNO CITTA
OEM	MOGLIANO VENETO
NMO	MOIANA
MAG	MOIO-ALCANTARA-MALVAGNA
MDB	MOLA DI BARI
MRL	MOLARE
MTF	MOLFETTA
MCV	MOLINA-CASTELVECCHIO SUBEQUO
DMA	MOLINO DEL PALLONE
MNL	MOLTENO
MEV	MOMBALDONE-ROCCAVERANO
MZU	MOMBARUZZO
MMO	MOMO
MES	MONASTERACE-STILO
MOP	MONASTERO-PRATAVECCHIA
MRI	MONCALIERI
MIE	MONCALIERI SANGONE
MVV	MONCALVO
OOM	MONCHIERO-DOGLIANI
MVI	MONDOVI'
MIL	MONEGLIA
MNF	MONFALCONE
NOM	MONGARDINO
EMO	MONGRASSANO-CERVICATI
MVD	MONGUELFO-CASIES WELSBERG-GSIES
MLP	MONOPOLI
MRD	MONSAMPOLO DEL TRONTO
MCE	MONSELICE
OMN	MONTAGNANA
OMA	MONTAGUTO-PANNI
MEI	MONTALE-AGLIANA
MSL	MONTALLESE
AMD	MONTALTO DI CASTRO
YZM	MONTALTO DORA
YMZ	MONTALTO-ROSE
MRN	MONTANARO
MET	MONTE ANTICO
MEU	MONTE ARCAU
MEG	MONTE GIORDANO
EME	MONTE MELINO
MSB	MONTE S.SAVINO
MLB	MONTEBELLO
MNB	MONTEBELLUNA
MBC	MONTECALVO-BUONALBERGO-CASALBORE
MSR	MONTECARLO-S. SALVATORE
MOB	MONTECAROTTO-CASTELBELLINO
MIC	MONTECATINI CENTRO
MIT	MONTECATINI TERME-MONSUMMANO
EOM	MONTECHIARO DENICE
OAM	MONTECHIARO D'ASTI
MNV	MONTECORVINO
MRS	MONTECOSARO
ONM	MONTEFALCIONE
YMM	MONTEFIASCONE
ZYM	MONTEFREDANE
MSG	MONTEGROSSO
MSI	MONTEIASI-MONTEMESOLA
MLN	MONTELLA
XZM	MONTELLO-GORLAGO
XYM	MONTELUPO-CAPRAIA
MRG	MONTEMAGGIORE BELSITO
MNM	MONTEMARANO
ZMY	MONTEMARCIANO
MTM	MONTEMILETTO
XMZ	MONTENERO-PETACCIATO
XMY	MONTEPAONE-MONTAURO
OML	MONTEPESCALI
MNP	MONTEPRANDONE
XMM	MONTEPULCIANO
EMA	MONTEREALE VALCELLINA
ZYX	MONTERODUNI S. EUSANIO
MIB	MONTERONI D'ARBIA
MST	MONTEROSSO
MOH	MONTEROSSO MARCHE
DMO	MONTEROTONDO-MENTANA
MOU	MONTESANO-BUONABITACOLO
MTS	MONTESANTO
WZX	MONTESILVANO
ODM	MONTEU DA PO
MIV	MONTEVARCHI-TERRANUOVA
WYX	MONTEVERDE
IME	MONTI-TELTI
IMO	MONTICCHIO
MIG	MONTICELLI D'ONGINA
ZXY	MONTICELLO D'ALBA
MUO	MONTIGLIO-MURISENGO
WXZ	MONTIRONE
MEJ	MONTJOVET
MOF	MONTORO-FORINO
OMU	MONTORO SUPERIORE
MSN	MONTORSI
MLR	MONTORSOLI
MZN	MONZA
MAI	MONZA SOBBORGHI
MMD	MONZONE-MONTE DEI BIANCHI-ISOLANO
WXY	MONZUNO-VADO
MSP	MORANO SUL PO
WXX	MORBEGNO
ZXM	MORCONE
YXM	MORENGO-BARIANO
MSU	MORES-ITTIREDDU
MTR	MORETTA
MEX	MORGEX
RMO	MORI
OIM	MORNAGO-CIMBRO
OLM	MOROLO
DME	MORRA DE SANCTIS-TEORA
MMS	MORROVALLE-MONTE S. GIUSTO
MRT	MORTARA
SMN	MOSCIANO S. ANGELO
SMO	MOSSA
MAR	MOTTA CAMASTRA
DMI	MOTTA DI LIVENZA
MSD	MOTTA S. DAMIANO
MSZ	MOTTA S. GIOVANNI-LAZZARO
WZM	MOTTEGGIANA
AMI	MOZIA-BIRGI
WYM	MOZZECANE
MTU	MULINETTI
MLU	MURATELLA
MUL	MURLO
MUE	MUSEI
MPD	MUSIANO-PIAN DI MACINA
MUT	MUSSOTTO
MDU	MUZZANA DEL TURGNANO
NIE	NAPOLI CENTRALE
NCF	NAPOLI CAMPI FLEGREI
NIG	NAPOLI GIANTURCO
NIM	NAPOLI MERGELLINA
NIO	NAPOLI MONTESANTO
NPG	NAPOLI PIAZZA GARIBALDI
NPL	NAPOLI PIAZZA LEOPARDI
NSG	NAPOLI S. GIOVANNI-BARRA
NIA	NARNI-AMELIA
NLE	NARZOLE
NSI	NASISI
NNO	NATURNO NATURNS
NII	NAVACCHIO
NVE	NEIVE
NAM	NERA MONTORO
NNN	NETTUNO
NIB	NIBBIA
NNI	NICHELINO
NVO	NICORVO
NRR	NICOTERA
NLA	NIELLA
NMM	NISCEMI
NDS	NIZZA DI SICILIA
NAO	NIZZA MONFERRATO
NES	NOALE-SCORZE'
NAI	NOCERA INFERIORE
NIT	NOCERA INFERIORE MERCATO
NAS	NOCERA SUPERIORE
NAE	NOCERA TIRINESE
NAU	NOCERA UMBRA
NTO	NOCETO
NRO	NOGARA
NLL	NOLA
NNE	NONE
NCC	NOTARESCO
NTT	NOTO
NSR	NOVA SIRI-ROTONDELLA
NRV	NOVARA
NMF	NOVARA-MONTALBANO-FURNARI
NEA	NOVATE MEZZOLA
NVV	NOVE
NIR	NOVI LIGURE
NNA	NOZZANO
NTE	NUCETTO
NOS	NUOVO SALARIO
NUS	NUS
NCS	NUSCO
OLO	OCCHIOBELLO
OZO	ODERZO
OCM	OFFIDA-CASTEL DI LAMA
ONO	OGGIONO
OIA	OLBIA
OMC	
OGO	OLCENENGO
OIO	OLCIO
OII	OLEGGIO
ONN	OLEVANO
OTA	OLGIATA
OCB	OLGIATE-CALCO-BRIVIO
OIT	OLIVERI-TINDARI
OSM	OLIVETTA S. MICHELE
OTT	OLMENETA
OIS	OLMI SPERCENIGO
ONA	OMEGNA
OAO	OMEGNA-CRUSINALLO
OOS	OMIGNANO-SALENTO
ORA	ORA AUER
OLL	ORBETELLO-MONTE ARGENTARIO
ONI	ORCIANO
OND	ORDONA
OIR	ORIA
OAP	ORICOLA-PERETO
OOL	ORIO LITTA
OLI	ORIOLO
ORI	ORIS EYRS
ONT	ORISTANO
OSO	ORNAVASSO
OSA	ORSA
OGG	ORSAGO
ODP	ORSARA DI PUGLIA
OAN	ORTA-MIASINO
OVA	ORTANOVA
OTE	ORTE
ONR	ORTONA
OTO	ORVIETO
ORR	OSCHIRI
OOO	OSIMO-CASTELFIDARDO
OGA	OSNAGO
OOE	OSPEDALETTO EUGANEO
OON	OSPEDALETTO LODIGIANO
OIH	OSPEDALICCHIO
ODE	OSPITALE DI CADORE
OOA	OSPITALETTO MANTOVANO
OOT	OSPITALETTO-TRAVAGLIATO
OAA	OSTERIA NUOVA
OAE	OSTIA PARMENSE
OIL	OSTIGLIA
ONU	OSTUNI
ONV	OTTAVIANO
OCS	OULX-CESANA-CLAVIERE-SESTRIERE
ODA	OVADA
OAD	OVADA NORD
OIG	OVIGLIO
OIN	OZIERI-CHILIVANI
OIF	
OOD	OZZANO
OOR	OZZANO MONFERRATO
ZSS	OZZANO TARO
POC	PALERMO CENTRALE
PCC	CANARO
PMB	BADESSE
PMV	
PIS	PABILLONIS
PDM	PACE DEL MELA
PCO	PACECO
PNO	PACHINO
POR	PADERNO-ROBBIATE
PNE	PADIGLIONE
PVA	PADOVA
PLA	PADULA
PLI	PADULI SUL CALORE
PSE	PAESE
PEC	PAESE-CASTAGNOLE
PUM	PAESTUM
PNI	PAGANI
PCA	PAGANICA
PLO	PALAGIANELLO
POA	PALAGIANO-CHIATONA
POM	PALAGIANO-MOTTOLA
PIA	PALAGONIA
PRO	PALERMO PALAZZO REALE-ORLEANS
PSG	PALAZZO S. GERVASIO-MONTEMILONE
PDS	PALAZZOLO DELLO STELLA
POS	PALAZZOLO SULL'OGLIO
POV	PALAZZOLO VERCELLESE
PNA	PALENA
POB	PALERMO BRANCACCIO
PON	PALERMO NOTARBARTOLO
PRR	PALESTRO
PNN	PALIDANO
PZI	PALIZZI
PNZ	PALLANZENO
PNR	PALLERONE
PSO	PALMA-S. GENNARO
PVV	PALMANOVA
PMI	PALMI
POL	PALO LAZIALE
PNB	PALOMBINA
PII	PANICAGLIA
PDC	PANTIERE DI CASTELBELLINO
PLL	PAOLA
PGO	PARABIAGO
POO	PARATICO SARNICO
POD	PARCO LEONARDO
PIL	PARGHELIA
PMA	PARMA
PAL	PARONA LOMELLINA
PCI	PARTINICO
PST	PASSIGNANO SUL TRASIMENO
PLP	PATERNOPOLI
PSP	PATTI-S. PIERO PATTI
PNT	PAULILATINO
PIV	PAVIA
PPG	PAVIA PORTA GARIBALDI
PNV	PAVONA
PSS	PEDASO
PCP	PEDEROBBA-CAVASO-POSSANGO
PNL	PELLEZZANO
PGG	PENANGO
PDE	PERAROLO DI CADORE
PNG	PERGINE
PLG	PERGOLA
PRI	PERI
PGN	PERTENGO
PIG	PERUGIA
PPS	PERUGIA PONTE S. GIOVANNI
PRA	PESARO
PRC	PESCARA CENTRALE
PPN	PESCARA PORTA NUOVA
PSM	PESCARA S.MARCO
PDG	PESCHIERA DEL GARDA
PIC	PESCIA
PNC	PESCINA
PLE	PESCOCANALE
POI	PESCOLANCIANO-CHIAUCI
PFL	PESCOSANNITA-FRAGNETO L'ABATE
PNS	PESSIONE
PEN	PETINA
POT	PETROSINO-STRASATTI
PCS	PETTENASCO
PSI	PETTORANO SUL GIZIO
PZA	PIACENZA
PND	PIADENA
PDN	PIAN DEL MUGNONE
PDV	PIAN DI VENOLA
PIN	PIANA
PBM	PIANA BELLA DI MONTELIBRETTI
PDR	PIANA DEL SIGNORE
PDA	PIANEROTTOLO D'ARIANO
PEI	PIANFEI
PDB	PIANO D'ORTA BOLOGNANO
PIO	PIANO ORIZZONTALE DEI GIOVI
PRN	PIANORO
NPI	PIANZANO
PAS	PIAZZA AL SERCHIO
PAA	NAPOLI PIAZZA AMEDEO
PAC	NAPOLI PIAZZA CAVOUR
NIP	PICERNO
PRE	PIEDIMULERA
PAE	PIETRA LIGURE
PRS	PIETRABISSARA
PLR	PIETRAGALLA
PLT	PIETRAPAOLA
PSA	PIETRARSA-S. GIORGIO A CREMANO
PTA	PIETRASANTA
IPN	PIETRELCINA
PEA	PIEVE ALBIGNOLA
PEL	PIEVE LIGURE
PEV	PIEVE VERGONTE
PTT	PIEVETTA
POE	PIGNATARO MAGGIORE
POP	PINAROLO PO
PLN	PINEROLO
OPL	PINEROLO OLIMPICA
PTO	PINETO-ATRI
OPT	PINETO-ATRI
INP	PINZANO
OPI	PIOLTELLO-LIMITO
PNM	PIOMBINO
PBE	PIOMBINO MARITTIMA
PEO	PIOMBINO DESE
ZPP	PIONA
PDO	PIOPPE DI SALVARO
PTE	PIRAINETO
PBA	PISA FERMATA AEROPORTO
PAR	PISA CENTRALE
PSR	PISA S. ROSSORE
PDP	PISCINA DI PINEROLO
PLC	PISCIOLO
PAP	PISCIOTTA-PALINURO
PCT	PISTICCI
PIT	PISTOIA
PIE	PITECCIO
PNH	PIZZIGHETTONE GERA
PZO	PIZZO
PUS	PLAUS PLAUS
PHE	PLOAGHE
PIP	POCAPAGLIA
PSN	POGGIBONSI-S. GIMIGNANO
PCV	POGGIO-CAREGGINE-VAGLI
POF	POGGIO FIDONI
PMO	POGGIO IMPERIALE
OIP	POGGIO MIRTETO
OPE	POGGIO RENATICO
POU	POGGIO RUSCO
NPO	POGGIORSINI
PTP	POGGIRIDENTI-TRESIVIO-PIATEDA
LPO	POGLIOLA
PLS	POLESELLA
PUO	POLICASTRO BUSSENTINO
OPU	POLICORO-TURSI
PAM	POLIGNANO A MARE
LOP	POLLA
PZZ	POLLENZA
NOP	POLLINA-S. MAURO CASTELVERDE
PIB	POMBIA
PSB	POMEZIA-S. PALOMBA
PEE	POMPEI
OPN	PONT CANAVESE
SPA	PONT SAINT MARTIN
PVE	PONTASSIEVE
APL	PONTE A ELSA
PAO	PONTE A MORIANO
PAT	PONTE A TRESSA
PET	PONTE ALBANITO
PEU	PONTE-CASALDUNI
PDI	PONTE DELLA VENTURINA
PDT	PONTE DI NONA
PID	PONTE DI PIAVE
PED	PIZZIGHETTONE-PONTE D'ADDA
PEG	PONTE D'ADIGE SIGMUNDSKRON
PER	PONTE GALERIA
EPA	PONTE GARDENA LAION/WAIDBRUCK LAJEN
EPI	PONTE GINORI
PAI	PONTE IN VALTELLINA
PNP	PONTE NELLE ALPI-POLPET
PPD	PONTE PARRANO DI NOCERA UMBRA
PSC	PONTE S. MARCO-CALCINATO
SPI	PONTE S. PIETRO
PBB	PONTEBBA
ONP	PONTECAGNANO
OPA	PONTECCHIO MARCONI
PNU	PONTECURONE
PCE	PONTEDERA-CASCIANA TERME
PRU	PONTELAGOSCURO
PFO	PONTELANDOLFO
PRT	PONTENURE
PTN	PONTETTO
PTI	PONTI
ZRR	PONTICINO
PDD	PONTIDA
PLM	PONTREMOLI
YZR	PONZANA
POG	PONZANO MAGRA
YRZ	POPOLANO DI MARRADI
PIR	POPOLI-VITTORITO
PIU	POPULONIA
RPO	PORCARI
YRR	PORDENONE
APE	PORRETTA TERME
PRM	PORTACOMARO
IPR	PORTICI-ERCOLANO
OEP	PORTO CERESIO
PAD	PORTO DI VASTO
APO	PORTO D'ASCOLI
OPM	PORTO EMPEDOCLE CENTRALE
EPO	PORTO RECANATI
PSD	PORTO S.ELPIDIO
PES	PORTO S. GIORGIO-FERMO
OPO	PORTO TORRES
AOP	PORTO VALTRAVAGLIA
PVP	PORTO VARALLO POMBIA
ZFF	PORTOGRUARO-CAORLE
PRG	PORTOMAGGIORE
PTD	POSSIDENTE
PMM	POSTIOMA
PCD	DOLCE
PAF	POTENZA CENTRALE
PPM	POTENZA PICENA-MONTELUPONE
PAU	POTENZA SUPERIORE
DPA	POVE DEL GRAPPA-CAMPESE
PLZ	POZZALLO
OOP	POZZOLO FORMIGARO
PIF	POZZUOLI SOLFATARA
YZF	POZZUOLO MARTESANA
PIH	PRACCHIA
ZYR	PRAJA-AJETA-TORTORA
OPR	PRASCO-CREMOLINO
APR	PRATA-PRATOLA
NPR	PRATIGNONE
XZR	PRATO BORGONUOVO
EOP	PRATO CENTRALE
PPA	PRATO PORTA AL SERRAGLIO
YZP	PRATO SESIA
PAN	PRATOLA PELIGNA
PPE	PRATOLA PELIGNA SUPERIORE
SPR	PREDOSA
POZ	PREGANZIOL
API	PREGNANA MILANESE
POH	PREMOSELLO-CHIOVENDA
PZE	PREZZA
SIP	PRE SAINT DIDIER
NRP	PRIMOLANO
PRL	PRIOLA
YPZ	PRIOLO-MELILLI
XYR	PRIOLO SOPRANO
ZRY	PRIVERNO-FOSSANOVA
APA	PUNTA RAISI
QNA	QUARONA
QRT	QUART
QDM	QUARTO DI MARANO
QOD	QUARTO D'ALTINO
QOV	QUATTRO VENTI
QLA	QUERCIANELLA-SONNINO
QOS	QUERO-VAS
QOO	QUILIANO-VADO LIGURE
QTO	QUINCINETTO
RAT	ROMA TERMINI
RCT	REGGIO DI CALABRIA AEROPORTO
RTO	RACALMUTO
RGI	RACCONIGI
RSA	RAGUSA
RAI	RAGUSA IBLA
RNO	RAIANO
RZO	RANDAZZO
RLO	RAPALLO
ROT	RAPOLANO TERME
RRS	RAPONE-RUVO-SAN FELE
RNN	RASTIGNANO
RNA	RAVENNA
RLE	RECALE
RCC	RECCO
RIA	REDIPUGLIA
RCL	REGGIO DI CALABRIA CENTRALE
RCD	REGGIO DI CALABRIA LIDO
RDC	REGGIO DI CALABRIA CATONA
RDO	REGGIO DI CALABRIA GALLICO
RDR	REGGIO DI CALABRIA PELLARO
RDI	REGGIO DI CALABRIA S. GREGORIO
ROE	REGGIO EMILIA
REA	REGGIO EMILIA AV
RDD	REGOLEDO
ROS	REMEDELLO SOPRA
ROO	REMEDELLO SOTTO
REV	RENATE-VEDUGGIO
RNS	RESANA
RRE	REVERE
RDS	REVIGLIONE DI SOMMA VESUVIANA
RHO	RHO
RIC	RIACE
RDA	RIARDO-PIETRAMELARA
RID	RICADI
RNE	RICCIONE
RTI	RIETI
ROG	RIGNANO GARGANICO
RSR	RIGNANO SULL'ARNO-REGGELLO
RLI	RIGOLI
RNG	RIGOMAGNO
RSO	RIGOROSO
RNI	RIMINI
RIM	RIMINI MIRAMARE
RTP	RIMINI TORRE PEDRERA
RIV	RIMINI VISERBA
RDP	RIO DI PUSTERIA
REO	RIO SECO
RDE	RIOFREDDO
RLA	RIOLA
RRR	RIOMAGGIORE
RAA	RIONERO-ATELLA-RIPACANDIDA
RSE	RIPABOTTONI-S. ELIA
RTA	RIPAFRATTA
RLL	RIPARBELLA
RIN	RISANO
RAO	RIVA TRIGOSO
RAS	RIVALTA SCRIVIA
RIP	RIVISONDOLI-PESCOCOSTANZO
RIO	ROBBIO
ROP	ROBECCO-PONTEVICO
RTE	ROBILANTE
RDN	ROCCA DI CORNO
RDF	ROCCA DI FONDI
RAD	ROCCA D'EVANDRO-S. VITTORE
RAE	ROCCA IMPERIALE
RAL	ROCCA RAVINDOLA
RDB	ROCCABERNARDA
RIE	ROCCACIGLIE
RDL	ROCCADEBALDI
RDM	ROCCAGRIMALDA
RAM	ROCCALUMERA-MANDANICI
RTT	ROCCAMURATA
ALR	ROCCAPALUMBA-ALIA
RSS	ROCCARASO
RCS	ROCCASECCA
RDT	ROCCASTRADA
RNV	ROCCAVIONE
RAJ	ROCCELLA JONICA
RAC	ROCCHETTA CAIRO
RSC	ROCCHETTA S. ANTONIO-LACEDONIA
RTC	ROCCHETTA TANARO-CERRO
RLD	RODALLO
RLG	ROGOLO
RNF	ROLO-NOVI-FABBRICO
RAU	ROMA AURELIA
YPP	ROMA CASILINA
RMM	ROMA MONTE MARIO
RNL	ROMA NOMENTANA
ARS	ROMA OSTIENSE
RAP	ROMA PRENESTINA
RSF	ROMA S. FILIPPO NERI
RSP	ROMA S. PIETRO
RAB	ROMA TIBURTINA
RTS	ROMA TIBURTINA
RAV	ROMA TRASTEVERE
RUA	ROMA TUSCOLANA
ROA	ROMAGNANO SESIA
ROV	ROMAGNANO-VIETRI-SALVITELLE
RNM	ROMANO
RRO	ROMANORE
ERA	ROMETTA MESSINESE
RDG	RONCANOVA DI GAZZO VERONESE
RBM	RONCEGNO BAGNI-MARTER
ROD	RONCHI DEI LEGIONARI NORD
RON	RONCIGLIONE
ROR	RONCO SCRIVIA
RTN	RONTA
RNR	ROSARNO
SRO	ROSA
RCU	ROSETO-CAPO SPULICO
RDZ	ROSETO DEGLI ABRUZZI
NOR	ROSIGNANO
ORN	ROSOLINA
ZYP	ROSOLINI
XZP	ROSSANO
ORE	ROSSANO VENETO
XYP	ROSSIGLIONE
TRO	ROSTA
RNT	ROTTOFRENO
RDV	ROVASENDA
LAR	
RTV	ROVATO
RLB	ROVERBELLA
RTR	ROVERETO
ZPY	ROVIANO
RGO	ROVIGO
RRA	RUBIERA
RZA	RUDALZA
RNU	RUFINA
RSI	RUSSI
RUN	RUTINO
SSA	S. AMBROGIO
SAD	S. ANTONINO DI SALUGGIA
SAE	S. ANTONINO-VAIE
SCV	S. CASSIANO VALCHIAVENNA
SCN	S. CRISTINA E BISSONE
SDD	S. DAMIANO D'ASTI
SDE	S. DONA' DI PIAVE-JESOLO
SSE	S. EUROSIA
SGV	S. GERMANO VERCELLESE
SGD	S. GIACOMO DI TEGLIO
SGI	S. GIOVANNI IN CROCE
SGM	S. GIULIANO MILANESE
SGP	S. GIULIANO PIACENTINO
SML	S. MARGHERITA LIGURE-PORTOFINO
SMD	S. MARIA DELLE MOLE
SND	S. NICOLA DI MELFI
SPS	S. PAOLO SOLBRITO
SPO	S. PIETRO A VICO
SPT	S. PIETRO AVELLANA-CAPRACOTTA
SPB	S. PIETRO-BERBENNO
SPV	S. PIETRO VERNOTICO
SSD	S. STEFANO DI MAGRA
SSZ	S. STINO DI LIVENZA
SSV	S. VINCENZO
SZF	S. ZENO-FOLZANO
SZA	S. ZENONE AL LAMBRO
SAM	S. AGATA DI MILITELLO
SAO	S. AGATA SUL SANTERNO
SAR	S. ALESSIO SICULO-FORZA D'AGRO'
SAI	S. ANDREA DELLO JONIO
SAA	S. ANGELO DEI LOMBARDI
SAL	S. ANNA ROBELLA
SAN	S. ANTIMO-S. ARPINO
SAT	S. ANTONIO MANTOVANO
SAG	SANTARCANGELO DI ROMAGNA
SBD	S. BENEDETTO DEL TRONTO
SBO	S. BENIGNO DI CUNEO
SSB	S. BIAGIO
SBA	S. BIAGIO DI CALLALTA
SSC	S. CANDIDO INNICHEN
SSO	S. CASSIANO
SSL	S. CATALDO
SCD	S. CATERINA DELLO JONIO
SSI	S. CLAUDIO
SCH	S. CRISTOFORO AL LAGO-ISCHIA
SCG	SANTA CROCE DEL LAGO
ASC	S. CROCE DEL SANNIO
SDI	S. DEMETRIO DE' VESTINI
SDB	S. DONNINO
SEE	S. ELENA-ESTE
SSR	S. ELLERO
SFS	S. FELICE SUL PANARO
SSF	S. FILIPPO
SFA	S. FILIPPO-S. LUCIA
SLS	S. FLAVIA-SOLUNTO-PORTICELLO
SFO	S. FREDIANO A SETTIMO
SGO	S. GIACOMO DI SPOLETO
SGC	S. GIORGIO CASALE
SGE	S. GIORGIO DELLE PERTICHE
SPG	S. GIORGIO DI PIANO
SGA	S. GIOVANNI AL NATISONE
SGS	S. GIOVANNI DI CASARSA
ASG	S. GIOVANNI D'ASSO
SGN	S. GIOVANNI VALDARNO
SSG	S. GIULETTA
SGT	S. GIULIANO PIEMONTE
SGR	S. GIULIANO TERME
SGU	S. GIUSEPPE VESUVIANO
SEG	S. GIUSTINA-CESIO
XPZ	S. ILARIO D'ENZA
SST	S. LIBERATO
SLC	PALERMO S. LORENZO
SLM	S. LORENZO MAGGIORE
SLA	S. LUCIDO MARINA
SMF	S. MARCELLINO-FRIGNANO
SMR	S. MARCO-ROGGIANO
SMC	S. MARIA CAPUA VETERE
SMA	SANTA MARIA LA BRUNA
SMG	S. MARIA LA LONGA
SMT	S. MARIA OLIVETO
SSM	S. MARINO
SMI	S. MARTINO AL CIMINO
SMB	S. MARTINO BUONALBERGO
SMP	S. MARTINO DI LUPARI
ASM	S. MARTINO IN GATTARA
SMS	S. MARTINO IN PENSILIS
SME	S. MICHELE DI SERINO
SOM	S. MICHELE IN BOSCO
SMH	S. MINIATO-FUCECCHIO
SSN	S. NAZARIO
SNA	S. NICOLA ARCELLA
SNT	S. NICOLA (TONNARA)
SIS	S. NICOLO'
SPE	S. PIERO A SIEVE
SPD	S. PIETRO A MAIDA-MAIDA
SPL	S. PIETRO IN CASALE
SPU	S. PIETRO IN GU
SRM	S. ROMANO-MONTOPOLI-S. CROCE
SSP	S. SEBASTIANO PO
SSH	S. SEVERINO MARCHE
SSS	
SES	S. STEFANO BELBO
SOS	S. STEFANO LODIGIANO
SSU	S. STEFANO UDINESE
STD	S. TOMMASO DEL PIANO
SVV	S. VINCENZO VALLE ROVETO
SVA	S. VITO AL TAGLIAMENTO
SVD	S. VITO DEI NORMANNI
SVL	S. VITO-LANCIANO
ISS	S. VITTORIA
SLE	SACILE
XPY	SACILE-S. LIBERALE
SDO	SAGRADO
STP	SAINT PIERRE
SNO	SAIRANO
SOZ	SAIRANO-ZINASCO
SAB	SALA AL BARRO-GALBIATE
SOA	SALA CONSILINA
SRA	SALANDRA-GROTTOLE
SNN	SALBERTRAND
SEL	SALE LANGHE
SIG	SALEMI-GIBELLINA
SNR	SALERNO
STO	SALETTO
STT	SALICETO
SDR	SALINE DI REGGIO
SNE	SALONE
SNL	SALORNO SALURN
SET	SALSOMAGGIORE TERME
SIA	SALUGGIA
SLL	SALUSSOLA
SAP	SALZA IRPINA
SOR	SALZANO-ROBEGANO
SII	SAMASSI-SERRENTI
SIO	SAMOGGIA
SCC	SAMOLACO
SRI	SAMPIERI
SBS	SAN BENEDETTO SAMBRO-CASTIGLIONE P.
SNB	S. BONIFACIO
SNG	S. GAVINO
SNM	S. GIACOMO
SNI	S. GIORGIO
SGG	S. GIORGIO DI NOGARO
SNV	
GSE	S. GIOVANNI IN PERSICETO
AGS	S. GIUSEPPE DI CAIRO
SLD	S. LEONARDO DI CUTRO
SDM	S. MARCO D'ALUNZIO-TORRENOVA
SMU	S. MAURO LA BRUCA
SON	S. MOMME'
NSB	S. NICOLA VARCO DI EBOLI
SEN	SANREMO
SNS	S. SEVERO
NSA	SANDIGLIANO
SRE	SANFRE
XPP	SANGIANO
STE	SANGINETO
STN	SANGUINETTO
SIT	SANLURI STATO
SRR	SANNAZZARO
SDA	SANNICANDRO DI BARI
AOS	SANTA DOMENICA
SAU	SANTA LUCE
SMZ	S. MARIA DI CATANZARO
ZXP	S. MARINELLA
SEA	SANTA SEVERA
STA	S. TERESA DI RIVA
SEM	SANTE MARIE
SMM	SANTERAMO
SIH	SANTHIA
YXP	S. STEFANO DI CAMASTRA-MISTRETTA
SIR	SANTUARIO
SOI	SANTUARIO INCORONATA
WZP	S. ANNA
SLO	
SOO	SANZANO-OCCHINO
SRP	SAPRI
STM	SARMATO
WYP	SARNO
WXP	SARONNO
ZPX	SARRE
YPX	SARTIRANA
SNZ	SARZANA
OAS	SASSA-TORNIMPARTE
SOT	SASSANO-TEGGIANO
SRS	SASSARI
WPZ	SASSO MARCONI
SOV	SASSOFERRATO-ARCEVIA
WPY	SASSONE
WPX	SAVIGLIANO
SOG	SAVIGNANO-GRECI
SUS	SAVIGNANO SUL RUBICONE
WPP	SAVONA
ZWW	
SVS	SCAFA-S. VALENTINO-CARAMANICO TERME
STI	SCAFATI
SDG	
YZW	SCALEA-S. DOMENICA TALAO
SHE	SCALENGHE
SAZ	SCALETTA ZANCLEA
SOB	SCANZANO-BELFIORE
SJM	SCANZANO JONICO-MONTALBANO JONICO
SNC	SCARLINO
SDP	SCERNE DI PINETO
SIC	SCHIO
SLI	SCICLI
LCS	SCILLA
STC	SCOPETI
SLT	SCORCETOLI
SID	SCORDIA
YWZ	SCURCOLA MARSICANA
GES	SECUGNAGO
OSR	SEDICO-BRIBANO
AES	SEGESTA TEMPIO
STR	SEGRATE
SDC	SELLA DI CORNO
YWW	SELLIA MARINA
SDT	SELVA DEL BOCCHETTO
SIL	SENIGALLIA
SNP	SEPINO
NSE	SEREGNO
TSE	SERIATE
ESN	SERINO
SSQ	SERRA S. QUIRICO
SCF	SERRADIFALCO
ESA	SERRALUNGA-CERESETO
SUA	SERRAMANNA-NURAMINIS
SLV	SERRAVALLE ALL'ADIGE
SED	SERRAVALLE D'ASTI
SEP	SERRAVALLE PISTOIESE
SEI	SERRAVALLE SCRIVIA
SDN	SERRE DI RAPOLANO
ZYW	SESSA AURUNCA-ROCCAMONFINA
SDS	SESSANO DEL MOLISE
SOE	SESTO CALENDE
SOP	SESTO CAMPANO
SOF	SESTO FIORENTINO
XZW	SESTO S. GIOVANNI
SIE	SESTRI LEVANTE
SEB	SETTEBAGNI
SCR	SETTEQUERCE SIEBENEICH
SCM	SETTIME-CINAGLIO-MOMBARONE
ESM	SETTIMO
XYW	SETTIMO-TAVAGNASCO
ENS	SETTINGIANO
ZWY	SEVEGLIANO
ESS	SEVESO
SER	SEZZE ROMANO
SLG	SGURGOLA
SRB	SIBARI
SDU	SICIGNANO DEGLI ALBURNI
SIN	SIDERNO
ISC	SIECI
NIS	SIENA
SZI	SIENA ZONA INDUSTRIALE
ISN	SIGNA
SRD	SILANDRO SCHLANDERS
SUU	SILIQUA
LSI	SILLA
SGL	SILLAVENGO
SVI	SILVI
ISR	SIMERI-CRICHI
GIS	SINALUNGA
INS	SIPICCIANO
TSI	SIPONTO
XWZ	SIRACUSA
AMS	SIRACUSA
XWY	SISTIANA-VISOGLIANO
XWW	SIZZANO
SOL	SLUDERNO-GLORENZA SCHLUDERNS-GLURNS
STF	SOFFRATTA
NSO	SOLAGNA
SLR	SOLAROLO
OSS	SOLARUSSA
SRL	SOLERO
VZZ	SOLIERA MODENESE
OSN	SOLIGNANO
SRF	SOLOFRA
SCP	SOLOPACA
VZY	SOMMA LOMBARDO
VYZ	SOMMARIVA DEL BOSCO
ISO	SONDRIO
ORS	SORA
ONS	SORESINA
SDH	SORGENTI DEL PESCHIERA
VYY	SORI
STV	SOVERATO
RPS	SPADAFORA
SLU	SPAGNUOLA
VZX	SPARANISE
DSC	SPARTIMENTO DI SCISCIANO
SLP	SPELLO
VYX	SPEZZANO ALBANESE TERME
SPN	SPIGNO
SLZ	SPINAZZOLA
IOS	SPINETOLI-COLLI
TSP	SPINETTA
STL	SPOLETO
ESP	SPONDINGA-PRATO SPONDINIG-PRAD
VXZ	SPOTORNO-NOLI
NSP	SPRESIANO
SCU	SQUILLACE
SNU	SQUINZANO
SLH	STANGHELLA
SPP	STAZIONE PER L'ALPAGO
NST	STICCIANO
NTS	STIMIGLIANO
VXY	STRADA CASALE
LST	STRADELLA
TSN	STRAMBINO
SDL	STRASSOLDO
STS	STRESA
SVE	STREVI
TNS	STRIGNO
VXX	STRONCONE
SLN	STRONGOLI
SUC	SU CANALE
SUN	SULMONA
SAQ	SULMONA-INTRODACQUA
NSU	SUNO
USS	SUSA
USN	SUSEGANA
SRZ	SUZZARA
TPN	TORINO PORTA NUOVA
TAA	TAGGIA ARMA
TZO	TAGLIACOZZO
TOA	TAINO-ANGERA
TNA	TALAMONA
TNE	TALAMONE
TNN	TAORMINA-GIARDINI
TTO	TARANTO
TTT	TARCENTO
TIA	TARGIA
TII	TARQUINIA
TIS	TARSIA
TOB	TARVISIO BOSCOVERDE
TNO	TASSIGNANO-CAPANNORI
TSS	TAURASI
TNZ	TAVAZZANO
TEN	TEANO
TOV	TEGLIO VENETO
TEC	TELESE-CERRETO
TMO	TERAMO
TOO	TERLANO-ANDRIANO TERLAN-ANDRIAN
TEA	TERME EUGANEE-ABANO-MONTEGROTTO
TEV	TERME VIGLIATORE
TIE	TERMINI IMERESE
TLI	TERMOLI
TVB	TERNATE-VARANO BORGHI
TNI	TERNI
TIC	TERNI COSPEA
TNR	TERNO
TAC	TERONTOLA-CORTONA
TNC	TERRACINA
TAT	TERRAROSSA-TRESANA
TVE	TERRENOVE
TIR	TERRIA
TNG	TERZIGNO
TOM	TERZO-MONTABONE
TDG	TEZZE DI GRIGNO
TNH	THIENE
TIO	THURIO
TRA	TIERA
TDA	TIONE DEGLI ABRUZZI
TIN	TIRANO
TIU	TISSI-USINI
TTI	TITO
TLL	TIVOLI
TOE	TOCCO-CASTIGLIONE
TNT	TOLENTINO
TCS	TOLLO-CANOSA SANNITA
TLO	TOMBOLO
TON	PALERMO TOMMASO NATALE
TOI	TONCO-ALFIANO
TRS	TOR SAPIENZA
TRV	TOR VERGATA
TAP	TORA-PRESENZANO
TOL	TORANO-LATTARICO
TRR	TORCHIARA
TOD	TORINO DORA GTT
TOT	TORINO LINGOTTO
TPS	TORINO PORTA SUSA
TSO	
TOS	TORINO STURA
TBA	TORRALBA
TPA	TORRAZZA PIEMONTE
TAE	TORRE ANNUNZIATA CENTRALE
TAI	TORRE ANNUNZIATA CITTA
TDP	TORRE DEI PASSERI
TDO	TORRE DEL GRECO
TDL	TORRE DEL LAGO PUCCINI
TDI	TORRE DE' PICENARDI
TIP	TORRE IN PIETRA-PALIDORO
TEM	TORRE MELISSA
TEO	TORRE ORSAIA
TEP	TORRE PELLICE
TSG	TORRE S. GIORGIO
TTE	TORREBERETTI
TRI	TORRENIERI-MONTALCINO
TLA	TORRICELLA
TLC	TORRICOLA
TSL	TORRILE-S. POLO
TDS	TORRITA DI SIENA
NOT	TORTONA
OTI	TORTORETO LIDO
TSA	TORVISCOSA
TIB	TRABIA
TRN	TRANI
TNP	TRAPANI
TPP	TRAPPA
TTP	TRAPPETO
TAB	TRAVEDONA-BIANDRONNO
TIV	TRAVESIO
TEI	TRE CROCI
THE	TREBASELEGHE
TCE	TREBISACCE
TTA	TRECATE
TLE	TRECELLA
TRE	TREMESTIERI
TTN	TRENTO
TZI	TREPUZZI
TAO	TRESENDA-APRICA-TEGLIO
TVI	TREVI
TIL	TREVIGLIO
TVO	TREVIGLIO OVEST
TOR	TREVIGNANO-SIGNORESSA
OTC	TREVISO CENTRALE
ZPT	TREZZANO SUL NAVIGLIO
TEL	
TEE	TRIESTE CENTRALE
TSF	TRINITAPOLI-S. FERDINANDO DI PUGLIA
TBV	TRINITA'-BENE VAGIENNA
OET	TRINO VERCELLESE
TPE	TRIUGGIO-PONTE ALBIATE
TNV	TRIVIGNO
TLR	TROFARELLO
TCI	TROIA-CASTELLUCCIO SAURI
TLM	TROMELLO
NTR	TRONZANO
TER	TROPEA
TFO	TUFO
TST	TUORO SUL TRASIMENO
TSU	TUSA
TNU	TUTURANO
UNE	UDINE
UAV	UGOVIZZA-VALBRUNA
USM	URAS-MOGORO
UAS	URBISAGLIA-SFORZACOSTA
UIR	URURI-ROTELLO
VSL	VENEZIA S. LUCIA
VPN	VERONA PORTA NUOVA
VPF	VITERBO PORTA FIORENTINA
VDA	VADA
VIA	VAGLIA
VOB	VAGLIO BASILICATA
VNO	VAIANO
VNN	VAIRANO-CAIANELLO
VAA	VALDAORA-ANTERSELVA OLANG-ANTHOLZ
VNA	VALDIBRANA
VZA	VALENZA
VEA	VALLE AURELIA
VDM	VALLE DI MADDALONI
VDO	VALLE DI MERCATO S. SEVERINO
VEL	VALLE LOMELLINA
VII	VALLECROSIA
VMO	VALLEDOLMO
VGA	VALLELUNGA
VDL	VALLO DELLA LUCANIA-CASTELNUOVO
VND	VALMADONNA
VRA	VALMADRERA
VNE	VALMONTONE
VNI	VALTOPINA
VES	VANDOIES VINTL
VOP	VANZAGO-POGLIANO
VOD	VAPRIO D'AGOGNA
VOA	VARALLO POMBIA
VOS	VARALLO SESIA
VNR	VARANO
VZE	VARAZZE
VAE	VARENNA-ESINO
VSE	VARESE
VNG	VARIGNANA
VSS	VASTO-S. SALVO
VDI	VASTOGIRARDI
VEO	VENEZIA ASSEGGIANO
VRI	VELLETRI
VRO	VENAFRO
VCO	VENETICO
VAC	VENEZIA CARPENEDO
VAM	VENEZIA S. LUCIA
VAR	VENEZIA MESTRE
VPM	VENEZIA PORTO MARGHERA
VAO	VENOSA-MASCHITO
VIL	VENTIMIGLIA
VNZ	VENZONE
VAP	VERBANIA-PALLANZA
VIE	VERCEIA
VLI	VERCELLI
VSG	VERCURAGO-S. GIROLAMO
VOE	VERDELLO-DALMINE
VTO	VERGATO
VTE	VERGIATE
VCC	VERGNASCO
VTT	VERNANTE
VZN	VERNAZZA
VMC	VERNIO-MONTEPIANO-CANTAGALLO
VVA	VEROLANUOVA
VGO	VEROLENGO
VCD	
VPV	VERONA PORTA VESCOVO
VEE	VERRES
VLO	VERZUOLO
VTA	VESPOLATE
VRR	PALERMO VESPRI
VLA	VETRALLA
VOL	VEZZANO LIGURE
VAB	VIADANA BRESCIANA
VIO	VIAREGGIO
VOM	VIBO MARINA
VVP	VIBO VALENTIA-PIZZO
VLL	VICARELLO
VIH	VICCHIO
VZC	VICENZA
VOO	VICO MATRINO
VLE	VICOFERTILE
VSM	VICOFORTE-S. MICHELE
VRV	VICOVARO
VGG	VIDALENGO
VSR	VIETRI SUL MARE-AMALFI
VNV	VIGEVANO
VOC	VIGLIANO-CANDELO
VOZ	VIGLIANO D'ABRUZZO
VOI	VIGLIANO D'ASTI
VDV	VIGNA DI VALLE
VLN	VIGNALE
VER	VIGNALE-RIOTORTO
VTN	VIGNATE
VRE	VIGODARZERE
VIN	VIGONE
VAG	VIGONZA-PIANIGA
VAI	VILLA BONELLI
VAD	VILLA CADE
VAL	VILLA CASTELLI
VAU	VILLA CLAUDIA
VDC	VILLA DEL CONTE
VDT	VILLA DI TIRANO
VAT	VILLA LITERNO
VPA	VILLA OPICINA
VAV	VILLA RAVERIO
VSO	VILLA S. GIOVANNI-CANNITELLO
VSI	VILLA S. GIOVANNI
VSN	VILLA S. SEBASTIANO
VEM	VILLABARTOLOMEA
VAS	VILLABASSA BRAIES/NIEDERDORF PRAGS
VTB	
VLS	VILLADOSSOLA
YZT	VILLAFRANCA-BAGNONE
VCA	VILLAFRANCA-CANTARANA
VDN	VILLAFRANCA DI VERONA
AVP	VILLAFRANCA PIEMONTE
AVI	VILLAFRANCA TIRRENA-SAPONARA
VBA	VILLALBA
VRG	VILLAMAGGIORE
AVO	VILLAMASSARGIA-DOMUSNOVAS
VVV	VILLANOVA
VDR	VILLANOVA DI REGGIOLO
YPT	VILLANOVA D'ARDA
VAH	VILLANOVA D'ARDENGHI
IVA	VILLAPIANA LIDO
VTC	VILLAPIANA-TORRE CERCHIARA
VSA	VILLAROSA
VTS	VILLASANTA
VOR	VILLASOR
AVT	VILLASPECIOSA-UTA
VNL	VILLASTELLONE
AOV	VILLAVERLA-MONTECCHIO
NVI	VILLAZZANO
VVE	VILLENEUVE
VTL	VILLETTA
ZYT	VILLETTA-MALAGNINO
SVO	VILLETTA S. ROMANO
VON	VILPIANO-NALLES VILPIAN-NALS
VRU	VINCHIATURO
VNT	VIPITENO VAL VIZZE/STERZING PFITSCH
VNS	VISANO
NIV	VISONE
VPR	VITERBO PORTA ROMANA
VIR	VITTORIA
VOV	VITTORIO VENETO
VEN	VITTUONE-ARLUNO
VOF	VITULANO-FOGLIANISE
VSU	VITUSO
IVN	VIZZINI-LICODIA
VRH	VOGHERA
XZT	VOGOGNA OSSOLA
NOV	VOLTANA
VSP	VOLTERRA-SALINE-POMARANCE
ZLO	ZAGAROLO
ZRA	ZAMBRA
ZNE	ZAMBRONE
ZLU	ZAPPULLA
ZON	ZINASCO NUOVO
ZLI	ZOAGLI
AEO	ALBAIRATE
INF	NAPOLI AFRAGOLA