Abano Terme	TERME EUGANEE-ABANO-MONTEGROTTO
Abbadia Lariana	ABBADIA LARIANA
Abbasanta	ABBASANTA
Abbiategrasso	ABBIATEGRASSO
Acate	ACATE
Acciano	ACCIANO
Acerra	ACERRA
Acireale	ACIREALE
Acqua Acetosa	ACQUA ACETOSA
Acquafredda	ACQUAFREDDA
Acquanegra Cremonese	ACQUANEGRA CREMONESE
Acquappesa	ACQUAPPESA
Acquaviva	ACQUAVIVA-CASTELTERMINI
Acquaviva Delle Fonti	ACQUAVIVA DELLE FONTI
Acquedolci-S.Fratello	ACQUEDOLCI-S.FRATELLO
Acqui Terme	ACQUI TERME
Acri Bisignano Luzzi	ACRI-BISIGNANO-LUZZI
Adria	ADRIA
Africo Nuovo	AFRICO NUOVO
Agliano Castelnuovo Calcea	AGLIANO-CASTELNUOVO CALCEA
Agrigento Bassa	AGRIGENTO BASSA
Agrigento Centrale	AGRIGENTO CENTRALE
Agrigento C.le	AGRIGENTO CENTRALE
Agropoli Castellabate	AGROPOLI-CASTELLABATE
Airasca	AIRASCA
Airole	AIROLE
Airuno	AIRUNO
Ala	ALA
Alanno	ALANNO
Alano Fener Valdobbiadene	ALANO-FENER-VALDOBBIADENE
Alassio	ALASSIO
Alba	ALBA
Alba Adriatica Nereto Contr.	ALBA ADRIATICA-NERETO-CONTROGUERRA
Albacina	ALBACINA
Albano Di Lucania	ALBANO DI LUCANIA
Albano Laziale	ALBANO LAZIALE
Albano S.Alessandro	ALBANO S. ALESSANDRO
Albanova	ALBANOVA
Albaredo	ALBAREDO
Albate Camerlata	ALBATE-CAMERLATA
Albate-Trecallo	ALBATE TRECALLO
Albenga	ALBENGA
Alberese	ALBERESE
Albinia	ALBINIA
Albisola	ALBISOLA
Albizzate Solbiate Arno	ALBIZZATE-SOLBIATE ARNO
Albonese	ALBONESE
Albuzzano	ALBUZZANO
Alcamo Diramazione	ALCAMO DIRAMAZIONE
Alcantara	ALCANTARA
Alessandria	ALESSANDRIA
Alfedena-Scontrone	ALFEDENA-SCONTRONE
Alfonsine	ALFONSINE
Alice Belcolle	ALICE BELCOLLE
Ali` Terme	ALI TERME
Allerona-Castel Viscardo	ALLERONA-CASTEL VISCARDO
Alpignano	ALPIGNANO
Altamura	ALTAMURA
Altare	ALTARE
Altavilla Irpina	ALTAVILLA IRPINA
Altavilla M.	ALTAVILLA MILICIA
Altavilla Tavernelle	ALTAVILLA-TAVERNELLE
Altopascio	ALTOPASCIO
Alviano	ALVIANO
Amantea	AMANTEA
Ambivere Mapello	AMBIVERE-MAPELLO
Amendola	AMENDOLA
Amendolara Oriolo	AMENDOLARA-ORIOLO
Amorosi Melizzano	AMOROSI-MELIZZANO
Anagni-Fiuggi	ANAGNI-FIUGGI
Ancona	ANCONA
Ancona Marittima	ANCONA M.MA
Ancona Torrette	ANCONA TORRETTE
Anconetta	ANCONETTA
Andora	ANDORA
Angri	ANGRI
Anguillara	ANGUILLARA
Annone Veneto	ANNONE VENETO
Antignano	ANTIGNANO
Antrodoco Borgo Velino	ANTRODOCO-BORGO VELINO
Antrodoco Centro	ANTRODOCO CENTRO
Anversa-Villalago-Scanno	ANVERSA-VILLALAGO-SCANNO
Anzano Del Parco	ANZANO DEL PARCO
Anzio	ANZIO
Anzio Colonia	ANZIO COLONIA
Aosta	AOSTA
Aosta Istituto	AOSTA ISTITUTO
Aosta Viale Europa	AOSTA VIALE EUROPA
Apice S.Arcangelo Bonito	APICE-S. ARCANGELO-BONITO
Appiano	APPIANO PROBA PETRONIA
Apricena	APRICENA
Aprilia	APRILIA
Aquilonia	AQUILONIA
Aragona Caldare	ARAGONA-CALDARE
Arbia	ARBIA
Arce	ARCE
Arcisate	ARCISATE
Arcola	ARCOLA
Arcore	ARCORE
Ardara	ARDARA
Ardenno Masino	ARDENNO-MASINO
Ardore	ARDORE
Arena Po	ARENA PO
Arenzano	ARENZANO
Arezzo	AREZZO
Argenta	ARGENTA
Ariano Irpino	ARIANO IRPINO
Arona	ARONA
Arpino	ARPINO
Arquata Scrivia	ARQUATA SCRIVIA
Arqua`	ARQUA
Arsoli	ARSOLI
Artegna	ARTEGNA
Arvier	ARVIER
Ascea	ASCEA
Asciano	ASCIANO
Asciano Monte Oliveto Maggiore	ASCIANO-MONTE OLIVETO MAGGIORE
Ascoli Piceno	ASCOLI PICENO
Ascoli Satriano	ASCOLI SATRIANO
Asola	ASOLA
Assemini	ASSEMINI
Assisi	ASSISI
Asso	ASSO
Asti	ASTI
Atena	ATENA
Attigliano	ATTIGLIANO-BOMARZO
Augusta	AUGUSTA
Auletta	AULETTA
Aulla	AULLA LUNIGIANA
Aulla Lunigiana	AULLA LUNIGIANA
Aurisina	AURISINA
Avellino	AVELLINO
Aversa	AVERSA
Avezzano	AVEZZANO
Aviano	AVIANO
Avigliana	AVIGLIANA
Avigliano Lucania	AVIGLIANO LUCANIA
Avio	AVIO
Avise	AVISE
Avola	AVOLA
Bari Centrale	BARI CENTRALE
Bari C.le	BARI CENTRALE
Bologna Centrale	BOLOGNA CENTRALE
Bologna C.le	BOLOGNA CENTRALE
Badia Polesine	BADIA POLESINE
Badolato	BADOLATO
Bagheria	BAGHERIA
Bagnacavallo	BAGNACAVALLO
Bagnara	BAGNARA
Bagnaria Arsa	BAGNARIA ARSA
Bagnasco	BAGNASCO
Bagni Di Lucca	BAGNI DI LUCCA
Bagni Di Tivoli	BAGNI DI TIVOLI
Bagnoli Agnano Terme	BAGNOLI-AGNANO TERME
Bagnoli Irpino	BAGNOLI IRPINO
Bagnolo Mella	BAGNOLO MELLA
Baiano Di Spoleto	BAIANO DI SPOLETO
Baldichieri	BALDICHIERI-TIGLIOLE
Balestrate	BALESTRATE
Balsorano	BALSORANO
Balvano R.	BALVANO-RICIGLIANO
Balzola	BALZOLA
Bandito	BANDITO
Baragiano	BARAGIANO-RUOTI
Baranello	BARANELLO
Barbianello	BARBIANELLO
Barbiano	BARBIANO
Barbusi	
Barcellona	BARCELLONA-CASTROREALE
Bardonecchia	BARDONECCHIA
Barga Gallicano	BARGA-GALLICANO
Bari Palese Macchie	BARI PALESE-MACCHIE
Bari Parco Nord	BARI PARCO NORD
Bari Parco Sud	BARI PARCO SUD
Bari S. Spirito	BARI S. SPIRITO
Bari S.Andrea	BARI S. ANDREA
Bari S.Giorgio	BARI S. ANDREA
Bari Torre A Mare	BARI TORRE A MARE
Baricetta	BARICETTA
Barile	BARILE
Barletta	BARLETTA
Baronissi	BARONISSI
Baschi-Montecchio	BASCHI-MONTECCHIO
Basiliano	BASILIANO
Bassano Del Grappa	BASSANO DEL GRAPPA
Bassano In Teverina	BASSANO IN TEVERINA
Bassano Romano	BASSANO ROMANO
Bastia	BASTIA
Bastia Mondovi`	BASTIA MONDOVI
Battaglia Terme	BATTAGLIA TERME
Battipaglia	BATTIPAGLIA
Bauladu Milis	BAULADU-MILIS
Baveno	BAVENO
Bazzana	BAZZANA
Beaulard	BEAULARD
Beffi	BEFFI
Beinette	BEINETTE
Belgioioso	BELGIOIOSO
Belgirate	BELGIRATE
Bella Muro	BELLA-MURO
Bellano Tartavelle Terme	BELLANO-TARTAVALLE TERME
Bellante Ripattone	BELLANTE-RIPATTONE
Bellaria	BELLARIA
Bellavista	BELLAVISTA
Bellinzago	BELLINZAGO
Bellisio Solfare	BELLISIO SOLFARE
Belluno	BELLUNO
Belmonte Calabro	BELMONTE CALABRO
Belvedere Marittimo	BELVEDERE MARITTIMO
Benevento	BENEVENTO
Benevento Arco Traiano	BENEVENTO ARCO TRAIANO
Benevento Porta Rufina	BENEVENTO PORTA RUFINA
Berceto	BERCETO
Berchidda	BERCHIDDA
Bergamasco	BERGAMASCO
Bergamo	BERGAMO
Bernalda	BERNALDA
Besana	BESANA
Besnate	BESNATE
Besozzo	BESOZZO
Beura Cardezza	BEURA-CARDEZZA
Bevera	BEVERA
Bevilacqua	BEVILACQUA
Biagioni Lagacci	BIAGIONI LAGACCI
Bianco	BIANCO
Bianze`	BIANZE'
Bianzone	BIANZONE
Biassono-Lesmo Parco	BIASSONO-LESMO
Bibiana	BIBIANA
Bicocca	BICOCCA
Biella Chiavazza	BIELLA-CHIAVAZZA
Biella S.Paolo	BIELLA S. PAOLO
Biforco	BIFORCO
Binario S.Marco Vecchio	FIRENZE S. MARCO VECCHIO
Bisceglie	BISCEGLIE
Bistagno	BISTAGNO
Bisuschio Viggiu	BISUSCHIO-VIGGIU'
Bitetto Palo Del Colle	BITETTO-PALO DEL COLLE
Bivio D`Aurisina	BIVIO D'AURISINA
Boccia Al Mauro	BOCCIA AL MAURO
Bogliasco	BOGLIASCO
Boiano	BOIANO
Bolgheri	BOLGHERI
Bologna Borgo Panigale	BOLOGNA BORGO PANIGALE
Bologna Centrale/Av	BOLOGNA CENTRALE
Bologna C.le/Av	BOLOGNA CENTRALE
Bologna Corticella	BOLOGNA CORTICELLA
Bologna Fiere	BOLOGNA FICO-EW
Bologna Mazzini	BOLOGNA MAZZINI
Bologna Ravone	
Bologna S.Ruffillo	BOLOGNA S. RUFFILLO
Bolzano 	BOLZANO BOZEN
Bolzano Novarese	BOLZANO NOVARESE
Bolzano Sud 	BOLZANO SUD BOZEN SUD
Bonassola	BONASSOLA
Bonefro S.Croce	BONEFRO-S. CROCE
Bonferraro	BONFERRARO
Bonorva	BONORVA
Bordighera	BORDIGHERA
Borghetto	BORGHETTO SULL'ADIGE
Borghetto Parmense	BORGHETTO PARMENSE
Borghetto Santo Spirito	BORGHETTO S. SPIRITO
Borgio Verezzi	BORGIO-VEREZZI
Borgo	BORGO
Borgo A Buggiano	BORGO A BUGGIANO
Borgo A Mozzano	BORGO A MOZZANO
Borgo Fornari Per Voltaggio	BORGO FORNARI PER VOLTAGGIO
Borgo Lavezzaro	BORGO LAVEZZARO
Borgo Revel	BORGO REVEL
Borgo S. Lorenzo	BORGO S. LORENZO
Borgo S.L.Rimorelli	BORGO S. LORENZO-RIMORELLI
Borgo S.Martino	BORGO S. MARTINO
Borgo San Dalmazzo	BORGO S. DALMAZZO
Borgo Ticino	BORGO TICINO
Borgo Val Di Taro	BORGO VAL DI TARO
Borgo Valsugana Centro	BORGO VALSUGANA CENTRO
Borgo Valsugana Est	BORGO VALSUGANA EST
Borgo Vercelli	BORGO VERCELLI
Borgoforte	BORGOFORTE
Borgofranco	BORGOFRANCO
Borgolombardo	BORGO LOMBARDO
Borgomanero	BORGOMANERO
Borgone	BORGONE
Borgoratto	BORGORATTO
Borgosesia	BORGOSESIA
Borore	BORORE
Boschi S.Anna	BOSCHI S. ANNA
Bosco Redole	BOSCO REDOLE
Boscoreale	BOSCOREALE
Botricello	BOTRICELLO
Bova Marina	BOVA MARINA
Bovalino	BOVALINO
Bovino Deliceto	BOVINO-DELICETO
Bovolone	BOVOLONE
Bozzolo	BOZZOLO
Bra	BRA
Bracciano	BRACCIANO
Bragno	BRAGNO
Brancaleone	BRANCALEONE
Brandizzo	BRANDIZZO
Breil Sur Roya	BREIL-SUR-ROYA
Brenna-Alzate	BRENNA-ALZATE
Brennero	BRENNERO BRENNER
Brescia	BRESCIA
Bressana Argine	BRESSANA ARGINE
Bressana Bottarone	BRESSANA BOTTARONE
Bressanone	BRESSANONE BRIXEN
Briatico	BRIATICO
Bricherasio	BRICHERASIO
Brindisi	BRINDISI
Brindisi Di Montagna	BRINDISI DI MONTAGNA
Brindisi Marittima	BRINDISI M.MA
Briona	BRIONA
Brisighella	BRISIGHELLA
Brolo Ficarra	BROLO-FICARRA
Broni	BRONI
Bronzolo 	BRONZOLO BRANZOLL
Brozolo	BROZOLO
Brunico 	BRUNICO BRUNECK
Bruno	BRUNO
Bruzolo	BRUZOLO DI SUSA
Buccino S.	BUCCINO-S. GREGORIO MAGNO
Bucine	BUCINE
Budoia Polcenigo	BUDOIA-POLCENIGO
Bugnara	BUGNARA
Buonconvento	BUONCONVENTO
Buonfornello	BUONFORNELLO
Buronzo	BURONZO
Busalla	BUSALLA
Busca	BUSCA
Busche Lentiai Mel	BUSCHE-LENTIAI-MEL
Busseto	BUSSETO
Bussi	BUSSI
Bussoleno	BUSSOLENO
Busto Arsizio	BUSTO ARSIZIO
Buttafava	BUTTAFAVA
Buttapietra	BUTTAPIETRA
Buttrio	BUTTRIO
Cadeo	CADEO
Cagliari	CAGLIARI
Cagliari Elmas	CAGLIARI-ELMAS
Cairo Montenotte	CAIRO MONTENOTTE
Cala Sabina	CALA SABINA
Calalzo Pieve Cadore Cortina	CALALZO-PIEVE DI CADORE-CORTINA
Calalzo PC Cort.	CALALZO-PIEVE DI CADORE-CORTINA
Calamandrana	CALAMANDRANA
Calatabiano	CALATABIANO
Calatafimi	CALATAFIMI
Calceranica	CALCERANICA
Calciano	CALCIANO
Calcio	CALCIO
Calde`	CALDE
Caldiero	CALDIERO
Caldonazzo	CALDONAZZO
Calenzano	CALENZANO
Calitri Pescopagano	CALITRI-PESCOPAGANO
Calolziocorte Olginate	CALOLZIOCORTE-OLGINATE
Calopezzati	CALOPEZZATI
Caltagirone	CALTAGIRONE
Caltanissetta Centrale	CALTANISSETTA CENTRALE
Caltanissetta C.le	CALTANISSETTA CENTRALE
Caltanissetta Xirbi	CALTANISSETTA XIRBI
Caltignaga	CALTIGNAGA
Calusco	CALUSCO
Caluso	CALUSO
Calvisano	CALVISANO
Camaiore Lido Capezzano	CAMAIORE LIDO-CAPEZZANO
Cambiano	CAMBIANO
Cambiano Santena	CAMBIANO-SANTENA
Cammarata S.Giovanni Gemini	CAMMARATA-S. GIOVANNI GEMINI
Camnago-Lentate	CAMNAGO-LENTATE
Camogli San Fruttuoso	CAMOGLI-S. FRUTTUOSO
Campagna Serre Persano	CAMPAGNA-SERRE-PERSANO
Campello	CAMPELLO SUL CLITUNNO
Campiglia Marittima	CAMPIGLIA MARITTIMA
Campo Di Carne	CAMPO DI CARNE
Campo Di Giove	CAMPO DI GIOVE
Campo Di Giove-Monte Maiella	CAMPO DI GIOVE MONTE MAIELLA
Campo Di Nusco	CAMPO DI NUSCO
Campo Di Trens 	CAMPO DI TRENS FREIENFELD
Campobasso	CAMPOBASSO
Campobello Di Mazara	CAMPOBELLO DI MAZARA
Campobello Ravanusa	CAMPOBELLO-RAVANUSA
Campodarsego	CAMPODARSEGO
Campofelice	CAMPOFELICE
Campofranco	CAMPOFRANCO
Campolattaro	CAMPOLATTARO
Campoleone	CAMPOLEONE
Campolieto Monacilioni	CAMPOLIETO-MONACILIONE
Campoligure Masone	CAMPO LIGURE-MASONE
Campomaggiore	CAMPOMAGGIORE-PIETRAPERTOSA
Campomarino	CAMPOMARINO
Campomela	CAMPOMELA
Campomigliaio	CAMPOMIGLIAIO
Campora S.Giov. Serra Aiello	CAMPORA-S. GIOVANNI-SERRA AIELLO
Camporgiano	CAMPORGIANO
Camposampiero	CAMPOSAMPIERO
Camposanto	CAMPOSANTO
Camucia Cortona	CAMUCIA-CORTONA
Cancelliera	CANCELLIERA
Cancello	CANCELLO
Cancello Arnone	CANCELLO-ARNONE
Candela	CANDELA-S. AGATA DI PUGLIA
Candelo	CANDELO
Candia Canavese	CANDIA CANAVESE
Candia Lomellina	CANDIA LOMELLINA
Candida	CANDIDA
Candiolo	CANDIOLO
Candoglia Ornavasso	CANDOGLIA-ORNAVASSO
Canegrate	CANEGRATE
Canelli	CANELLI
Canetra	CANETRA
Canicatti`	CANICATTI'
Caniga	CANICATTI'
Cannara	CANNARA
Canne Della Battaglia	CANNE DELLA BATTAGLIA
Canneto Sull`Oglio	CANNETO SULL'OGLIO
Canosa Di Puglia	CANOSA DI PUGLIA
Cantalupo Del Sannio	CANTALUPO DEL SANNIO-MACCHIAGODENA
Cantu`	CANTU
Cantu`- Cermenate	CANTU'-CERMENATE
Caorso	CAORSO
Capaccio Roccadaspide	CAPACCIO-ROCCADASPIDE
Capaci	CAPACI
Capalbio	CAPALBIO
Capannelle	CAPANNELLE
Capistrello	CAPISTRELLO
Capo Bonifati	CAPO BONIFATI
Capo D`Orlando-Naso	CAPO D'ORLANDO-NASO
Capo Spartivento	CAPO SPARTIVENTO
Capodacqua Pieve Fanonica	CAPODACQUA-PIEVE FANONICA
Cappelle-Magliano	CAPPELLE-MAGLIANO
Capralba	CAPRALBA
Capranica	CAPRANICA-SUTRI
Caprarola	CAPRAROLA
Capriati Al Volturno	CAPRIATI A VOLTURNO
Capriolo	CAPRIOLO
Capriva	CAPRIVA
Capua	CAPUA
Carate-Calo`	CARATE-CALO'
Caravaggio	CARAVAGGIO
Carbona	CARBONA
Carbonara Scrivia	CARBONARA SCRIVIA
Carbonia Serbariu	CARBONIA SERBARIU
Cardillo Zen	PALERMO CARDILLO-ZEN
Carentino	CARENTINO
Cariati	CARIATI
Carimate	CARIMATE
Carini	CARINI
Carini Torre Ciachea	CARINI-TORRE CIACHEA
Carisio	CARISIO
Carmagnola	CARMAGNOLA
Carmignano Di Brenta	CARMIGNANO DI BRENTA
Carnate Usmate	CARNATE-USMATE
Carnia	CARNIA
Caronia	CARONIA
Carovigno	CAROVIGNO
Carovilli-Roccasicura	CAROVILLI-ROCCASICURA
Carpane`Valstagna	CARPANE'-VALSTAGNA
Carpi	CARPI
Carpignano Sesia	CARPIGNANO SESIA
Carpinone	CARPINONE
Carrara Avenza	CARRARA-AVENZA
Carrito-Ortona	CARRITO-ORTONA
Carruba	CARRUBA
Carru` Clavesana	CARRU'-CLAVESANA
Carsoli	CARSOLI
Casabianca	CASABIANCA
Casacalenda Guardialfiera	CASACALENDA-GUARDIALFIERA
Casal Sabini	CASAL SABINI
Casalbordino Pollutri	CASALBORDINO-POLLUTRI
Casalbuono	CASALBUONO
Casalbuttano	CASALBUTTANO
Casale Monferrato	CASALE MONFERRATO
Casale Popolo	CASALE POPOLO
Casalecchio Di Reno	CASALECCHIO DI RENO
Casalecchio Garibaldi	CASALECCHIO GARIBALDI
Casaleggio	CASALEGGIO
Casaletto Vaprio	CASALETTO VAPRIO
Casalmaggiore	CASALMAGGIORE
Casalnuovo	CASALNUOVO DI NAPOLI
Casalpusterlengo	CASALPUSTERLENGO
Casarsa	CASARSA
Cascina	CASCINA
Caserta	CASERTA
Casino Di Terra	CASINO DI TERRA
Casletto-Rogeno	CASLETTO-ROGENO
Casorate Sempione	CASORATE SEMPIONE
Casoria	CASORIA-AFRAGOLA
Cassago-Nibionno-Bulciago	CASSAGO-NIBIONNO-BULCIAGO
Cassano All`Ionio	CASSANO ALLO JONIO
Cassano D`Adda	CASSANO D'ADDA
Cassano Irpino	CASSANO IRPINO
Cassine	CASSINE
Cassino	CASSINO
Cassola	CASSOLA
Castagnaro	CASTAGNARO
Castagneto Carducci	CASTAGNETO CARDUCCI-DONORATICO
Castagno	CASTAGNO
Castagnole Delle Lanze	CASTAGNOLE DELLE LANZE
Casteggio	CASTEGGIO
Castel Bagnolo Di Orte	CASTEL BAGNOLO DI ORTE
Castel Di Sangro	CASTEL DI SANGRO
Castel D`Ario	CASTEL D'ARIO
Castel Gandolfo	CASTEL GANDOLFO
Castel Lagopesole	CASTEL LAGOPESOLE
Castel Madama	CASTEL MADAMA
Castel S.Angelo	CASTEL S. ANGELO
Castel S.Giorgio Roccapiemonte	CASTEL S. GIORGIO-ROCCAPIEMONTE
Castel S.Giovanni	CASTEL S. GIOVANNI
Castel S.Pietro Terme	CASTEL S. PIETRO TERME
Castelbello	CASTELBELLO KASTELBELL
Castelbolognese	CASTELBOLOGNESE-RIOLO TERME
Castelbuono	CASTELBUONO
Casteldaccia	CASTELDACCIA
Casteldarne 	CASTELDARNE EHRENBURG
Casteldebole	CASTELDEBOLE
Castelferretti	CASTELFERRETTI-FALCONARA AEROPORTO
Castelfiorentino	CASTELFIORENTINO
Castelfranci	CASTELFRANCI
Castelfranco D'Emilia	CASTELFRANCO DI SOPRA
Castelfranco Veneto	CASTELFRANCO VENETO
Castelguelfo	CASTELGUELFO
Castellalto Canzano	CASTELLALTO-CANZANO
Castellammare Del Golfo	CASTELLAMMARE DEL GOLFO
Castellammare Di Stabia	CASTELLAMMARE DI STABIA
Castellaneta Marina	CASTELLANETA MARINA
Castellazzo Casalcermelli	CASTELLAZZO-CASALCERMELLI
Castelleone	CASTELLEONE
Castelletto Busca	CASTELLETTO BUSCA
Castelletto Ticino	CASTELLETTO TICINO
Castellina Ch	CASTELLINA IN CHIANTI-MONTERIGGIONI
Castellina Marittima	CASTELLINA M.MA
Castellino Tanaro	CASTELLINO TANARO
Castello Di Godego	CASTELLO DI GODEGO
Castello D`Annone	CASTELLO D'ANNONE
Castellucchio	CASTELLUCCHIO
Castell`Alfero	CASTELL'ALFERO
Castelmaggiore	CASTEL MAGGIORE
Castelnuovo	CASTELNUOVO BELBO
Castelnuovo Belbo	CASTELNUOVO BELBO
Castelnuovo Berardenga	CASTELNUOVO BERARDENGA
Castelnuovo Di Garfagnana	CASTELNUOVO DI GARFAGNANA
Castelplanio Cupramontana	CASTELPLANIO-CUPRAMONTANA
Castelraimondo Camerino	CASTELRAIMONDO-CAMERINO
Castelrosso	CASTELROSSO
Castelspina Portanova	CASTELSPINA-PORTANOVA
Castelvecchio Pascoli	CASTELVECCHIO PASCOLI
Castelvetere	CASTELVETERE
Castelvetrano	CASTELVETRANO
Castelvetro	CASTELVETRO
Castiglion Del Lago	CASTIGLIONE DEL LAGO
Castiglion Fiorentino	CASTIGLION FIORENTINO
Castiglioncello	CASTIGLIONCELLO
Castiglione Cosentino	CASTIGLIONE COSENTINO
Castiglione Di Sicilia	CASTIGLIONE DI SICILIA
Castiglione In Teverina	CASTIGLIONE IN TEVERINA
Castione Andevenno	CASTIONE ANDEVENNO
Castione Dei Marchesi	CASTIONE DEI MARCHESI
Castro-Pofi	CASTRO-POFI-VALLECORSA
Castronno	CASTRONNO
Catania Acquicella	CATANIA ACQUICELLA
Catania Centrale	CATANIA CENTRALE
Catania C.le	CATANIA CENTRALE
Catania Ognina	CATANIA OGNINA
Catanzaro	CATANZARO
Catanzaro Lido	CATANZARO LIDO
Catenanuova	CATENANUOVA-CENTURIPE
Cattolica S.Giovanni Gabicce	CATTOLICA-S. GIOVANNI-GABICCE
Caulonia	CAULONIA
Cava Carbonara	CAVA CARBONARA
Cava Dei Tirreni	CAVA DE' TIRRENI
Cava Manara	CAVA CARBONARA
Cava Tigozzi	CAVA TIGOZZI
Cavagnolo Brusasco	CAVAGNOLO-BRUSASCO
Cavalleggeri Aosta	CAVALLEGGERI AOSTA
Cavallermaggiore	CAVALLERMAGGIORE
Cavanella D`Adige	CAVANELLA D'ADIGE
Cavanella Po	CAVANELLA PO
Cavaria Oggiona Jerago	CAVARIA-OGGIONA-IERAGO
Cavazzale	CAVAZZALE
Cavi	CAVI
Ca` Di Boschetti	CA' DI BOSCHETTI
Ceccano	CECCANO
Cecchina	CECCHINA
Cecina	CECINA
Cefalu`	CEFALU
Ceggia	CEGGIA
Celano-Ovindoli	CELANO-OVINDOLI
Celle	CELLE
Celle Bulgheria Roccagloriosa	CELLE BULGHERIA-ROCCAGLORIOSA
Cengio	CENGIO
Centallo	CENTALLO
Centola	CENTOLA-PALINURO MARINA DI CAMEROTA
Ceprano-Falvaterra	CEPRANO-FALVATERRA
Cercenasco	CERCENASCO
Cerchio	CERCHIO
Cercina	CERCINA
Cerda	CERDA
Cerea	CEREA
Ceregnano	CEREGNANO
Ceriale	CERIALE
Cerignola	CERIGNOLA CAMPAGNA
Cernusco-Merate	CERNUSCO-MERATE
Cerreto D`Esi	CERRETO D'ESI
Certaldo	CERTALDO
Certosa Di Pavia	CERTOSA DI PAVIA
Cervaro	CERVARO
Cervia-Milano Marittima	CERVIA-MILANO MARITTIMA
Cervignano A.G.	CERVIGNANO-AQUILEIA-GRADO
Cervignasco	CERVIGNASCO
Cervo San Bartolomeo	
Cesano Di Roma	CESANO DI ROMA
Cese	CESE
Cesena	CESENA
Cesenatico	CESENATICO
Cetraro	CETRARO
Ceva	CEVA
Chambave	CHAMBAVE
Chatillon Saint Vincent	CHATILLON-SAINT VINCENT
Cherasco	CHERASCO
Chianche Ceppaloni	CHIANCHE-CEPPALONI
Chiaravalle	CHIARAVALLE
Chiari	CHIARI
Chiarone	CHIARONE
Chiasso	CHIASSO
Chiavari	CHIAVARI
Chiavenna	CHIAVENNA
Chieri	CHIERI
Chieti	CHIETI
Chieuti Serracapriola	CHIEUTI-SERRACAPRIOLA
Chignolo Po	CHIGNOLO PO
Chioggia	CHIOGGIA
Chiomonte	CHIOMONTE
Chirialza	CHIRIALZA
Chiuduno	CHIUDUNO
Chiuro	CHIURO
Chiusa 	CHIUSA KLAUSEN
Chiusano Cossombrone	CHIUSANO-COSSOMBRATO
Chiusi C.T.	CHIUSI-CHIANCIANO TERME
Chivasso	CHIVASSO
Ciampino	CIAMPINO
Ciardes	CIARDES TSCHARS
Cinisi Terrasini	CINISI-TERRASINI
Cirella Majera`	CIRELLA-MAJERA'
Ciro'	CIRO'
Cisano Caprino Bergamasco	CISANO-CAPRINO BERGAMASCO
Cismon Del Grappa	CISMON DEL GRAPPA
Cisterna Di Latina	CISTERNA DI LATINA
Cisternino	CISTERNINO
Citerna Taro	CITERNA TARO
Cittadella	CITTADELLA
Cittaducale	CITTADUCALE
Citta` Della Pieve	CITTA' DELLA PIEVE
Civate	CIVATE
Civita Castellana	CIVITA CASTELLANA-MAGLIANO
Civita D`Antino-Morino	CIVITA D'ANTINO-MORINO
Civitanova Marche	CIVITANOVA MARCHE-MONTEGRANARO
Civitavecchia	CIVITAVECCHIA
Civitavecchia M.Ma	CIVITAVECCHIA PORTO
Civitavecchia Viale Della Vittoria	CIVITAVECCHIA VIALE DELLA VITTORIA
Civitella Paganico	CIVITELLA-PAGANICO
Civitella Roveto	CIVITELLA ROVETO
Cixerri	
Classe	CLASSE
Coccaglio	COCCAGLIO
Cocconato	COCCONATO
Cocullo	COCULLO
Codogno	CODOGNO
Codola	CODOLA
Codroipo	CODROIPO
Cogoleto	COGOLETO
Coldrano-Martello	COLDRANO-MARTELLO GOLDRAIN-MARTELL
Colico	COLICO
Colle Isarco 	COLLE ISARCO GOSSENSASS
Colle Mattia	COLLE MATTIA
Colle Val D`Elsa	COLLE VAL D'ELSA
Collecchio	COLLECCHIO
Colleferro-Segni-Paliano	COLLEFERRO-SEGNI-PALIANO
Collegno	COLLEGNO
Collesalvetti	COLLESALVETTI
Collevecchio	COLLEVECCHIO-POGGIO SOMMAVILLA
Colli Di Monte Bove	COLLI DI MONTE BOVE
Cologne	COLOGNE
Colorno	COLORNO
Comignago	COMIGNAGO
Comiso	COMISO
Como S. Giovanni	COMO S. GIOVANNI
Compiobbi	COMPIOBBI
Condofuri	CONDOFURI
Condove	CONDOVE-CHIUSA S. MICHELE
Conegliano	CONEGLIANO
Conselice	CONSELICE
Contea Londa	CONTEA-LONDA
Contesse	CONTESSE
Contigliano	CONTIGLIANO
Contursi Terme	CONTURSI TERME
Corbetta S. Stefano	CORBETTA-S. STEFANO TICINO
Corbezzi	CORBEZZI
Corchiano	CORCHIANO
Cordovado Sesto	CORDOVADO-SESTO
Corigliano Calabro	CORIGLIANO CALABRO
Cormons	CORMONS
Corniglia	CORNIGLIA
Cornino	CORNINO
Cornuda	CORNUDA
Corridonia Mogliano	CORRIDONIA-MOGLIANO
Corsano	CORSANO
Corsico	CORSICO
Corteolona	CORTEOLONA
Cosenza	COSENZA
Cosio Traona	COSIO-TRAONA
Cossato	COSSATO
Costa	COSTA
Costa Masnaga	COSTA MASNAGA
Costigliole (Motta Di)	COSTIGLIOLE (MOTTA DI)
Costigliole D`Asti	COSTIGLIOLE D'ASTI
Costigliole Saluzzo	COSTIGLIOLE SALUZZO
Cotignola	COTIGNOLA
Cotilia	COTILIA
Cozze	COZZE
Cozzo	COZZO
Crema	CREMA
Cremona	CREMONA
Crescentino	CRESCENTINO
Cressa Fontaneto	CRESSA-FONTANETO
Crevalcore	CREVALCORE
Crocicchie	CROCICCHIE
Cropani	CROPANI
Crotone	CROTONE
Crucoli	CRUCOLI
Cucciago	CUCCIAGO
Cuneo	CUNEO
Cuneo Gesso	CUNEO GESSO
Cunico Scandeluzza	CUNICO-SCANDELUZZA
Cupone	CUPONE
Cupramarittima	CUPRAMARITTIMA
Cureggio	CUREGGIO
Cusano	CUSANO
Cutro	CUTRO
Cuzzago	CUZZAGO
Decimomannu	DECIMOMANNU
Dego	DEGO
Deiva Marina	DEIVA MARINA
Delebio	DELEBIO
Derby	DERBY
Dervio	DERVIO
Desenzano	DESENZANO DEL GARDA-SIRMIONE
Desio	DESIO
Diamante Buonvicino	DIAMANTE-BUONVICINO
Diano Marina	
Dicomano	DICOMANO
Diecimo - Pescaglia	DIECIMO-PESCAGLIA
Dittaino	DITTAINO
Dobbiaco 	DOBBIACO TOBLACH
Dolo	DOLO
Domegliara	DOMEGLIARA-S. AMBROGIO
Domodossola	DOMODOSSOLA
Donna	DONNA
Donnafugata	DONNAFUGATA
Donnaz	DONNAZ
Dorio	DORIO
Dormelletto	DORMELLETTO
Dormelletto Paese	DORMELLETTO PAESE
Dossobuono	DOSSOBUONO
Dronero	DRONERO
Dubino	DUBINO
Dueville	DUEVILLE
Dev.Int. Dd/Av	
Eboli	EBOLI
Eca Nasago`	ECA NASAGO
Eccellente	ECCELLENTE
Egna-Termeno 	EGNA-TERMENO NEUMARKT-TRAMIN
Egnazia	EGNAZIA
Ellera Corciano	ELLERA-CORCIANO
Empoli	EMPOLI
Enas	ENAS
Enna	ENNA
Equi Terme	EQUI TERME
Este	ESTE
Exilles	EXILLES
Firenze S.M.N.	FIRENZE S. M. NOVELLA
Fabriano	FABRIANO
Fabriano Ca` Maiano	FABRIANO-CA' MAIANO
Fabrica Di Roma	FABRICA DI ROMA
Fabro-Ficulle	FABRO-FICULLE
Faenza	FAENZA
Fae`Fortogna	FAE'-FORTOGNA
Fagare	FAGARE
Fagnano Campana	FAGNANO-CAMPANA
Falciano Mondragone Car.	FALCIANO-MONDRAGONE-CARINOLA
Falconara	FALCONARA
Falconara Marittima	FALCONARA MARITTIMA
Falconara Stadio	FALCONARA STADIO
Falcone	FALCONE
Falerna	FALERNA
Fanna - Cavasso	FANNA-CAVASSO
Fano	FANO
Fanzolo	FANZOLO
Fara	FARA
Fara Sabina	FARA SABINA-MONTELIBRETTI
Farigliano	FARIGLIANO
Fasano	FASANO
Fauglia - Lorenzana	FAUGLIA-LORENZANA
Favazzina	FAVAZZINA
Federico	PALERMO IMPERATORE FEDERICO
Felegara - S.Andrea Bagni	FELEGARA-S. ANDREA BAGNI
Felizzano	FELIZZANO
Feltre	FELTRE
Ferentino-Supino	FERENTINO-SUPINO
Feroleto Antica Pianopoli	FEROLETO ANTICO-PIANOPOLI
Ferrandina	FERRANDINA-SCALO MATERA
Ferrania	FERRANIA
Ferrara	FERRARA
Ferrera Lomellina	FERRERA LOMELLINA
Ferruzzano	FERRUZZANO
Fi Rovezzano	FIRENZE ROVEZZANO
Fidene	FIDENE
Fidenza	FIDENZA
Fiera	PALERMO FIERA
Fiesole Caldine	FIESOLE-CALDINE
Figline Valdarno	FIGLINE VALDARNO
Filattiera	FILATTIERA
Fildidonna	FILDIDONNA
Filiano	FILIANO
Finale Ligure Marina	FINALE LIGURE MARINA
Fiorenzuola	FIORENZUOLA
Firenze Campo Marte	FIRENZE CAMPO DI MARTE
Firenze Castello	FIRENZE CASTELLO
Firenze Rifredi	FIRENZE RIFREDI
Firenze Statuto	FIRENZE STATUTO
Fisciano	FISCIANO
Fiumefreddo Bruzio	FIUMEFREDDO BRUZIO
Fiumefreddo Di Sicilia	FIUMEFREDDO SICILIA
Fiumelatte	FIUMELATTE
Fiumetorto	FIUMETORTO
Fiumicino Aeroporto	FIUMICINO AEROPORTO
Fivizzano - Gassano	FIVIZZANO-GASSANO
Fivizzano Rometta - Soliera	FIVIZZANO-ROMETTA-SOLIERA
Foggia	FOGGIA
Foligno	FOLIGNO
Follonica	FOLLONICA
Fondi - Sperlonga	FONDI-SPERLONGA
Fontanafredda	FONTANAFREDDA
Fontanetto Po	FONTANETTO PO
Fontaniva	FONTANIVA
Fontebuona	FONTEBUONA
Fontecchio	FONTECCHIO
Forenza	FORENZA
Forgaria Bagni Anduins	FORGARIA-BAGNI ANDUINS
Forlimpopoli	FORLIMPOPOLI-BERTINORO
Forli`	FORLI
Formia-Gaeta	FORMIA-GAETA
Fornaci Di Barga	FORNACI DI BARGA
Fornovo	FORNOVO
Forte Dei Marmi Serravezza Q.	FORTE DEI MARMI-SERAVEZZA-QUERCETA
Fortezza 	FORTEZZA FRANZENSFESTE
Fosciandora - Ceserana	FOSCIANDORA-CESERANA
Fossacesia	FOSSACESIA-TORINO DI SANGRO
Fossacesia - Torino Di Sangro	FOSSACESIA-TORINO DI SANGRO
Fossalta Di Piave	FOSSALTA DI PIAVE
Fossalta Di Portogruaro	
Fossano	FOSSANO
Fossato Di Vico Gubbio	FOSSATO DI VICO-GUBBIO
Fragneto Monforte	FRAGNETO MONFORTE
Framura	FRAMURA
Francavilla	FRANCAVILLA DI SICILIA
Francavilla Al Mare	FRANCAVILLA AL MARE
Francavilla Angitola F.	FRANCAVILLA ANGITOLA-FILADELFIA
Francavilla Fontana	FRANCAVILLA FONTANA
Francia	PALERMO FRANCIA
Frascati	FRASCATI
Frasso T. Dugenta	FRASSO TELESINO-DUGENTA
Fratta	FRATTA
Frattamaggiore	FRATTAMAGGIORE-GRUMO
Frattarolo	FRATTAROLO
Fratte	FRATTE
Fratte Centro	FRATTE CENTRO
Fratte Villa Comunale	FRATTE - VILLA COMUNALE
Frosinone	FROSINONE
Frugarolo Boscomarengo	FRUGAROLO-BOSCOMARENGO
Funo Centergross	FUNO CENTERGROSS
Furci	FURCI
Fuscaldo	FUSCALDO
Genova P.Principe	GENOVA PIAZZA PRINCIPE
Gabella Grande	GABELLA GRANDE
Gaggi	GAGGI
Gaggiano	GAGGIANO
Gaggio	
Gagliole	GAGLIOLE
Gaibanella	GAIBANELLA
Gaifana	GAIFANA
Galati	GALATI
Galdo	GALDO
Gallarate	GALLARATE
Gallese Bassanello	GALLESE-BASSANELLO
Gallese In Teverina	GALLESE TEVERINA
Galliera	GALLIERA
Galliera Veneta Tombolo	GALLIERA VENETA-TOMBOLO
Gamalero	GAMALERO
Gambettola	GAMBETTOLA
Gambolo`Remondo`	GAMBOLO'-REMONDO'
Garbagna	GARBAGNA
Garessio	GARESSIO
Garlasco	GARLASCO
Gatteo A Mare	GATTEO A MARE
Gattinara	GATTINARA
Gavorrano	GAVORRANO
Gazzada Schianno Morazzone	GAZZADA-SCHIANNO-MORAZZONE
Gazzo Di Bigarello	GAZZO DI BIGARELLO
Gazzo Pieve S. Giacomo	GAZZO-PIEVE S. GIACOMO
Gela	GELA
Gemelli	GEMELLI
Gemona Del Friuli	GEMONA DEL FRIULI
Genga S.Vittore Terme	GENGA-S. VITTORE TERME
Genova Acquasanta	GENOVA ACQUASANTA
Genova Bolzaneto	GENOVA BOLZANETO
Genova Borzoli	GENOVA BORZOLI
Genova Brignole	GENOVA BRIGNOLE
Genova Cornigliano	GENOVA CORNIGLIANO
Genova Costa Di Sestri Ponente	GENOVA COSTA DI SESTRI PONENTE
Genova Granara	GENOVA GRANARA
Genova Marittima S. Limbania	GENOVA MARITTIMA
Genova Nervi	GENOVA NERVI
Genova P. Principe Sotterranea	GENOVA PIAZZA PRINCIPE
Genova Pegli	GENOVA PEGLI
Genova Pontedecimo	GENOVA PONTEDECIMO
Genova Pra	GENOVA PRA
Genova Quarto Dei Mille	GENOVA QUARTO DEI MILLE
Genova Quinto Al Mare	GENOVA QUINTO AL MARE
Genova Rivarolo	GENOVA RIVAROLO
Genova S.Biagio	GENOVA S.BIAGIO
Genova Sampierdarena	GENOVA SAMPIERDARENA
Genova Sestri Ponente	GENOVA SESTRI PONENTE AEROPORTO
Genova Sturla	GENOVA STURLA
Genova Vesima	GENOVA VESIMA
Genova Via Di Francia	GENOVA VIA DI FRANCIA
Genova Voltri	GENOVA VOLTRI
Ghedi	GHEDI
Ghemme	GHEMME
Ghislarengo	GHISLARENGO
Ghivizzano - Coreglia	GHIVIZZANO-COREGLIA
Giachery	PALERMO GIACHERY
Giampilieri	GIAMPILIERI
Giarole	GIAROLE
Giarre Riposto	GIARRE-RIPOSTO
Giave	GIAVE
Ginosa	GINOSA
Gioia Del Colle	GIOIA DEL COLLE
Gioia Tauro	GIOIA TAURO
Gioiosa Jonica	GIOIOSA JONICA
Giojosa Marea	GIOIOSA MAREA
Giovinazzo	GIOVINAZZO
Giugliano Qualiano	GIUGLIANO-QUALIANO
Giulianova	GIULIANOVA
Giuncano	GIUNCANO
Giuncarico	GIUNCARICO
Gizzeria Lido	GIZZERIA LIDO
Glorie	GLORIE
Godo	GODO
Gole Di Alcantara	GOLE DI ALCANTARA
Golfo Aranci	GOLFO ARANCI
Gonzaga-Reggiolo	GONZAGA-REGGIOLO
Gorgo Al Monticano	GORGO AL MONTICANO
Goriano Sicoli	GORIANO SICOLI
Gorizia Centrale	GORIZIA CENTRALE
Gorizia C.le	GORIZIA CENTRALE
Gozzano	GOZZANO
Gragnano	GRAGNANO
Gragnola	GRAGNOLA
Grammichele	GRAMMICHELE
Granaiolo	GRANAIOLO
Granarolo	GRANAROLO FAENTINO
Graniti	GRANITI
Grassano	GRASSANO-GARAGUSO-TRICARICO
Gravellona Toce	GRAVELLONA TOCE
Gravina In Puglia	GRAVINA IN PUGLIA
Greccio	GRECCIO
Gricignano	GRICIGNANO-TEVEROLA
Grignano	GRIGNANO
Grignasco	GRIGNASCO
Grigno	GRIGNO
Grisignano Di Zocco	GRISIGNANO DI ZOCCO
Grisolia S.Maria	GRISOLIA-SANTA MARIA
Grizzana	GRIZZANA
Gropello Cairoli	GROPELLO CAIROLI
Grosseto	GROSSETO
Grottaglie	GROTTAGLIE
Grottammare	GROTTAMMARE
Grotte	GROTTE
Grotte S.Stefano	GROTTE S. STEFANO
Grumello Del Monte	GRUMELLO DEL MONTE
Grumo Appula	GRUMO APPULA
Gualdo Tadino	GUALDO TADINO
Guardavalle	GUARDAVALLE
Guardia Mangano Santa Venerina	GUARDIA-MANGANO-S. VENERINA
Guardia Piemontese Terme	GUARDIA PIEMONTESE TERME
Guardiaregia	GUARDIAREGIA
Guidonia-Montecello-S.Angelo	GUIDONIA-MONTECELIO-S. ANGELO
Hone Bard	HONE-BARD
Igea Marina	IGEA MARINA
Iglesias	IGLESIAS
Il Cionfo Bin. Le Cure	LE CURE
Il Cionfo Bin. Salviati	SALVIATI
Il Neto	IL NETO
Imola	IMOLA
Imperia Oneglia	
Incisa	INCISA
Incisa Scapaccino	INCISA SCAPACCINO
Incoronata	INCORONATA
Indicatore	
Induno Olona	INDUNO OLONA
Ipogeo Degli Ottavi	IPOGEO DEGLI OTTAVI
Isernia	ISERNIA
Isola Capo Rizzuto	ISOLA CAPO RIZZUTO
Isola Del Cantone	ISOLA DEL CANTONE
Isola Della Scala	ISOLA DELLA SCALA
Isola Delle Femmine	ISOLA DELLE FEMMINE
Isola D`Asti	ISOLA D'ASTI
Isola Liri	ISOLA LIRI
Isoletta-S.Giovanni I.	ISOLETTA-S. GIOVANNI INCARICO
Ispica	ISPICA
Ispra	ISPRA
Istrana	ISTRANA
Itri	ITRI
Ivrea	IVREA
Jesi	JESI
Joppolo	JOPPOLO
La Fiora	LA FIORA
La Giustiniana	LA GIUSTINIANA
La Salle	LA SALLE
La Spezia Centrale	LA SPEZIA CENTRALE
La Spezia C.le	LA SPEZIA CENTRALE
La Spezia Migliarina	LA SPEZIA MIGLIARINA
La Storta	LA STORTA-FORMELLO
Labro Moggio	LABRO-MOGGIO
Laces	LACES LATSCH
Ladispoli-Cerveteri	LADISPOLI-CERVETERI
Lagonegro	LAGONEGRO
Laigueglia	LAIGUEGLIA
Laives 	LAIVES LEIFERS
Lama	LAMA
Lama Di Reno	LAMA DI RENO
Lambrinia	LAMBRINIA
Lamezia Terme Centrale	LAMEZIA TERME CENTRALE
Lamezia T. Centrale	LAMEZIA TERME CENTRALE
Lamezia T. C.le	LAMEZIA TERME CENTRALE
Lamezia Terme Nicastro	LAMEZIA TERME-NICASTRO
Lamezia T. Nicastro	LAMEZIA TERME-NICASTRO
Lamezia Terme Sambiase	LAMEZIA TERME-SAMBIASE
Lamezia T. Sambiase	LAMEZIA TERME-SAMBIASE
Lana-Postal 	LANA-POSTAL LANA-BURGSTALL
Lancenigo	LANCENIGO
Lanuvio	LANUVIO
Lanzara Fimiani	LANZARA-FIMIANI
Larino	LARINO
Lasa	LASA LAAS
Lascari	LASCARI
Laterina	LATERINA
Latiano	LATIANO
Latina	LATINA
Latisana Lignano B.	LATISANA-LIGNANO-BIBIONE
Lauriano	LAURIANO
Lavagna	LAVAGNA
Laveno Mombello	LAVENO-MOMBELLO
Lavezzola	LAVEZZOLA
Lavino	LAVINO
Lavis	LAVIS
Lavorate	LAVORATE
Le Piagge	LE PIAGGE
Lecce	LECCE
Lecco	LECCO
Lecco Maggianico	LECCO MAGGIANICO
Leggiuno Monvalle	LEGGIUNO-MONVALLE
Legnago	LEGNAGO
Legnano	LEGNANO
Lendinara	LENDINARA
Lentini	LENTINI
Lentini Diramazione	LENTINI DIRAMAZIONE
Leonessa	LEONESSA
Leonforte-Pirato	LEONFORTE-PIRATO
Lercara Bassa	LERCARA BASSA
Lerino	LERINO
Lesa	LESA
Lesegno	LESEGNO
Lesmo	LESMO
Letojanni	LETOJANNI
Levada	LEVADA
Levanto	LEVANTO
Levico	LEVICO TERME
Licata	LICATA
Lido Di Classe-Lido Di Savio	LIDO DI CLASSE-LIDO DI SAVIO
Lido Di Lavinio	LIDO DI LAVINIO
Lierna	LIERNA
Limone	LIMONE
Lioni	LIONI
Lioni Valle Delle Viti	LIONI-VALLE DELLE VITI
Lisiera	LISIERA
Lison	LISON
Lissone-Muggio`	LISSONE-MUGGIO'
Livorno Centrale	LIVORNO CENTRALE
Livorno C.le	LIVORNO CENTRALE
Livorno Ferraris	LIVORNO FERRARIS
Loano	LOANO
Locate Triulzi	LOCATE TRIULZI
Locri	LOCRI
Lodi	LODI
Lomello	LOMELLO
Lonato	LONATO
Longarone Zoldo	LONGARONE-ZOLDO
Longobardi	LONGOBARDI
Lonigo	LONIGO
Loreo	LOREO
Loreto	LORETO
Lucca	LUCCA
Lugo	LUGO
Luino	LUINO
Lumignacco	LUMIGNACCO
Lungavilla	LUNGAVILLA
Lunghezza	LUNGHEZZA
Luogosano	LUOGOSANO-S. MANGO SUL CALORE
Luserna S. Giovanni	LUSERNA SAN GIOVANNI
L`Aquila	L'AQUILA
Milano Centrale	MILANO CENTRALE
Milano C.le	MILANO CENTRALE
Maccarese	MACCARESE-FREGENE
Macerata	MACERATA
Macerata Fontescodella	MACERATA FONTESCODELLA
Macherio Sovico	MACHERIO-SOVICO
Macherio-Canonica	MACHERIO-CANONICA
Macomer	MACOMER
Maddalene	MADDALENE
Maddaloni Inferiore	MADDALONI INFERIORE
Maddaloni Superiore	MADDALONI SUPERIORE
Madignano	MADIGNANO
Madonna Del Piano	MADONNA DEL PIANO
Madonna Del Pilone	MADONNA DEL PILONE
Madonna Della Scala	MADONNA DELLA SCALA
Madonna Di Castro	MADONNA DI CASTRO
Maerne Di Martellago	MAERNE DI MARTELLAGO
Magenta	MAGENTA
Magione	MAGIONE
Magliana	MAGLIANA
Magliano Crava Morozzo	MAGLIANO-CRAVA-MOROZZO
Magre`- Cortaccia	MAGRE'-CORTACCIA MARGREID-KURTATSCH
Majano	MAJANO
Maleo	MALEO
Malles Venosta	MALLES VENOSTA MALS
Maltignano Del Tronto	MALTIGNANO
Manarola	MANAROLA
Mandatoriccio Campana	MANDATORICCIO-CAMPANA
Mandela-Sambuci	VALLE DELL'ANIENE-MANDELA-SAMBUCI
Mandello Del Lario	MANDELLO DEL LARIO
Manerbio	MANERBIO
Manfredonia	MANFREDONIA
Maniago	MANIAGO
Manoppello	MANOPPELLO
Manta	MANTA
Mantova	MANTOVA
Mantova Frassine	MANTOVA FRASSINE
Manzano	MANZANO
Manziana-Canale Monterano	MANZIANA-CANALE MONTERANO
Marano	MARANO VICENTINO
Marano Ticino	MARANO TICINO
Maratea	MARATEA
Marausa	MARAUSA
Marcaria	MARCARIA
Marcellina Verbicaro Orsomarso	MARCELLINA-VERBICARO-ORSOMARSO
Marcellina-Palombara	MARCELLINA-PALOMBARA
Marcellinara	MARCELLINARA
Marcianise	MARCIANISE
Marconia	MARCONIA
Marechiaro	MARECHIARO
Margarita	MARGARITA
Margherita Di Sav./Ofantino	S. 
Mariano Comense	MARIANO COMENSE
Marianopoli	MARIANOPOLI
Marigliano	MARIGLIANO
Marina Di Cerveteri	MARINA DI CERVETERI
Marina Di Maratea	MARINA DI MARATEA
Marina Di San Lorenzo	MARINA DI S. LORENZO
Marinella	MARINELLA
Marino	MARINO LAZIALE
Marino Del Tronto Folignano	MARINO DEL TRONTO-FOLIGNANO
Marlengo	MARLENGO MARLING
Marmore	MARMORE
Marotta Mondolfo	MAROTTA-MONDOLFO
Marradi	MARRADI-PALAZZUOLO SUL SENIO
Marrubiu Terralba Arborea	MARRUBIU-TERRALBA-ARBOREA
Marsala	MARSALA
Marzabotto	MARZABOTTO
Marzamemi	MARZAMEMI
Marzocca	MARZOCCA
Mascali	MASCALI
Maschio	MASCHIO
Massa Centro	MASSA CENTRO
Massafra	MASSAFRA
Massalombarda	MASSALOMBARDA
Massarosa Bozzano	MASSAROSA-BOZZANO
Matelica	MATELICA
Matrice Montagano	MATRICE-MONTAGANO-S.G. IN GALDO
Mazara Del Vallo	MAZARA DEL VALLO
Mede	MEDE
Medesano	MEDESANO
Meduno	MEDUNO
Meina	MEINA
Melano Marischio	MELANO-MARISCHIO
Mele	MELE
Melegnano	MELEGNANO
Melfi	MELFI
Melito Di Porto Salvo	MELITO DI PORTO SALVO
Melzo	MELZO
Meolo	MEOLO
Merana	MERANA
Merano	MERANO MERAN
Merano Maia Bassa	MERANO-MAIA BASSA MERAN-UNTERMAIS
Mercato San Severino	MERCATO S. SEVERINO
Mercenasco	MERCENASCO
Mergozzo	MERGOZZO
Merone	MERONE
Mesagne	MESAGNE
Messina Centrale	MESSINA CENTRALE
Messina C.le	MESSINA CENTRALE
Messina Marittima	MESSINA MARITTIMA
Mestrino	MESTRINO
Metaponto	METAPONTO
Mezzani Rondani	MEZZANI-RONDANI
Mezzano	MEZZANO
Mezzocorona	MEZZOCORONA
Mi P.Gar.Sott.	MILANO PORTA GARIBALDI
Mi.P.Genova	MILANO PORTA GENOVA
Mignanego	MIGNANEGO
Mignano Di Monte Lungo	MIGNANO MONTE LUNGO
Milano Bovisa Fnm	MILANO NORD BOVISA
Milano Certosa	MILANO CERTOSA
Milano Dateo	MILANO DATEO
Milano Greco Pirelli	MILANO GRECO PIRELLI
Milano Lambrate	MILANO LAMBRATE
Milano Lancetti	MILANO LANCETTI
Milano Porta Garibaldi	MILANO PORTA GARIBALDI
MI P.Garibaldi	MILANO PORTA GARIBALDI
Milano Porta Romana	MILANO PORTA ROMANA
MI P. Romana	MILANO PORTA ROMANA
Milano Porta Vittoria	MILANO PORTA VITTORIA
MI P. Vittoria	MILANO PORTA VITTORIA
Milano Rogoredo	MILANO ROGOREDO
Milano Romolo	MILANO ROMOLO
Milano S. Cristoforo	MILANO S. CRISTOFORO
Milano Venezia	MILANO PORTA VENEZIA
Milazzo	MILAZZO
Mileto	MILETO
Militello	MILITELLO
Mimmole	
Mineo	MINEO
Minervino Murge	MINERVINO MURGE
Minturno	MINTURNO-SCAURI
Minucciano - Pieve - Casola	MINUCCIANO-PIEVE-CASOLA
Mira Mirano	MIRA-MIRANO
Miradolo Terme	MIRADOLO TERME
Mirandola	MIRANDOLA
Mirto Crosia	MIRTO-CROSIA
Misano Adriatico	MISANO ADRIATICO
Modena	MODENA
Modica	MODICA
Modugno Citta`	MODUGNO CITTA
Mogliano Veneto	MOGLIANO VENETO
Moiana	MOIANA
Mojo-Alcantara Malvagna	MOIO-ALCANTARA-MALVAGNA
Mola Di Bari	MOLA DI BARI
Molare	MOLARE
Molfetta	MOLFETTA
Molina Castel Vecchio Subaqueo	MOLINA-CASTELVECCHIO SUBEQUO
Molino Del Pallone	MOLINO DEL PALLONE
Molteno	MOLTENO
Mombaldone Roccaverano	MOMBALDONE-ROCCAVERANO
Mombaruzzo	MOMBARUZZO
Momo	MOMO
Monasterace Stilo	MONASTERACE-STILO
Monastero Pratavecchi	MONASTERO-PRATAVECCHIA
Moncalieri	MONCALIERI
Moncalieri Sangone	MONCALIERI SANGONE
Moncalvo	MONCALVO
Monchiero Dogliani	MONCHIERO-DOGLIANI
Mondovi`	MONDOVI'
Moneglia	MONEGLIA
Monfalcone	MONFALCONE
Mongardino	MONGARDINO
Mongrassano Cervicati	MONGRASSANO-CERVICATI
Monguelfo Valle Di Casies	MONGUELFO-CASIES WELSBERG-GSIES
Monopoli	MONOPOLI
Monsampolo Del Tronto	MONSAMPOLO DEL TRONTO
Monselice	MONSELICE
Montagnana	MONTAGNANA
Montaguto Panni	MONTAGUTO-PANNI
Montale Agliana	MONTALE-AGLIANA
Montallese	MONTALLESE
Montalto Di Castro	MONTALTO DI CASTRO
Montalto Dora	MONTALTO DORA
Montalto Rose	MONTALTO-ROSE
Montanaro	MONTANARO
Monte Antico	MONTE ANTICO
Monte Arcau	MONTE ARCAU
Monte Giordano	MONTE GIORDANO
Monte Melino	MONTE MELINO
Monte S.Biagio	MONTE S.SAVINO
Montebello	MONTEBELLO
Montebelluna	MONTEBELLUNA
Montecalvo Buonalbergo Casalb.	MONTECALVO-BUONALBERGO-CASALBORE
Montecarlo San Salvatore	MONTECARLO-S. SALVATORE
Montecarotto Castelbellino	MONTECAROTTO-CASTELBELLINO
Montecatini Centro	MONTECATINI CENTRO
Montecatini Terme	MONTECATINI TERME-MONSUMMANO
Montechiaro Denice	MONTECHIARO DENICE
Montechiaro D`Asti	MONTECHIARO D'ASTI
Montecorvino	MONTECORVINO
Montecosaro	MONTECOSARO
Montefalcione	MONTEFALCIONE
Montefiascone	MONTEFIASCONE
Montefredane	MONTEFREDANE
Montegrosso	MONTEGROSSO
Monteiasi	MONTEIASI-MONTEMESOLA
Montella	MONTELLA
Montello Gorlago	MONTELLO-GORLAGO
Montelupo Capraia	MONTELUPO-CAPRAIA
Montemaggiore	MONTEMAGGIORE BELSITO
Montemarano	MONTEMARANO
Montemarciano	MONTEMARCIANO
Montemiletto	MONTEMILETTO
Montenero Petacciato	MONTENERO-PETACCIATO
Montepaone - Montauro	MONTEPAONE-MONTAURO
Montepescali	MONTEPESCALI
Monteprandone	MONTEPRANDONE
Montepulciano	MONTEPULCIANO
Montereale Valcellina	MONTEREALE VALCELLINA
Monteroduni	MONTERODUNI S. EUSANIO
Monteroni D`Arbia	MONTERONI D'ARBIA
Monterosso	MONTEROSSO
Monterosso Marche	MONTEROSSO MARCHE
Monterotondo	MONTEROTONDO-MENTANA
Montesano Buonabitacolo	MONTESANO-BUONABITACOLO
Montesanto	MONTESANTO
Montesilvano	MONTESILVANO
Monteu Da Po	MONTEU DA PO
Montevarchi Terranuova	MONTEVARCHI-TERRANUOVA
Monteverde	MONTEVERDE
Monti Telti	MONTI-TELTI
Monticchio	MONTICCHIO
Monticelli D`Ongina	MONTICELLI D'ONGINA
Monticello D`Alba	MONTICELLO D'ALBA
Montiglio Murisengo	MONTIGLIO-MURISENGO
Montirone	MONTIRONE
Montjovet	MONTJOVET
Montoro Forino	MONTORO-FORINO
Montoro Superiore	MONTORO SUPERIORE
Montorsi	MONTORSI
Montorsoli	MONTORSOLI
Monza	MONZA
Monza Sobborghi	MONZA SOBBORGHI
Monzone-M.Dei Banchi-Isolano	MONZONE-MONTE DEI BIANCHI-ISOLANO
Monzuno	MONZUNO-VADO
Morano Sul Po	MORANO SUL PO
Morbegno	MORBEGNO
Morcone	MORCONE
Morengo Bariano	MORENGO-BARIANO
Mores Ittireddu	MORES-ITTIREDDU
Moretta	MORETTA
Morgex	MORGEX
Mori	MORI
Mornago Cimbro	MORNAGO-CIMBRO
Morolo	MOROLO
Morra De Sanctis Teora	MORRA DE SANCTIS-TEORA
Morrovalle Monte S.Giusto	MORROVALLE-MONTE S. GIUSTO
Mortara	MORTARA
Mosciano S. Angelo	MOSCIANO S. ANGELO
Mossa	MOSSA
Motta Camastra	MOTTA CAMASTRA
Motta Di Livenza	MOTTA DI LIVENZA
Motta S. Damiano	MOTTA S. DAMIANO
Motta San Giovanni Lazzaro	MOTTA S. GIOVANNI-LAZZARO
Motteggiana	MOTTEGGIANA
Mozia-Birgi	MOZIA-BIRGI
Mozzecane	MOZZECANE
Mulinetti	MULINETTI
Muratella	MURATELLA
Murlo	MURLO
Musei	MUSEI
Musiano-Pian Di Macina	MUSIANO-PIAN DI MACINA
Mussotto	MUSSOTTO
Muzzana Del Turgnano	MUZZANA DEL TURGNANO
Napoli Centrale	NAPOLI CENTRALE
Napoli C.le	NAPOLI CENTRALE
Napoli Campi Flegrei	NAPOLI CAMPI FLEGREI
Napoli Gianturco	NAPOLI GIANTURCO
Napoli Mergellina	NAPOLI MERGELLINA
Napoli Montesanto	NAPOLI MONTESANTO
Napoli Piazza Garibaldi	NAPOLI PIAZZA GARIBALDI
Napoli Piazza Leopardi	NAPOLI PIAZZA LEOPARDI
Napoli S.Giov.Barra	NAPOLI S. GIOVANNI-BARRA
Narni Amelia	NARNI-AMELIA
Narzole	NARZOLE
Nasisi	NASISI
Naturno	NATURNO NATURNS
Navacchio	NAVACCHIO
Neive	NEIVE
Nera Montoro	NERA MONTORO
Nettuno	NETTUNO
Nibbia	NIBBIA
Nichelino	NICHELINO
Nicorvo	NICORVO
Nicotera	NICOTERA
Niella	NIELLA
Niscemi	NISCEMI
Nizza Di Sicilia	NIZZA DI SICILIA
Nizza Monferrato	NIZZA MONFERRATO
Noale Scorze`	NOALE-SCORZE'
Nocera Inferiore	NOCERA INFERIORE
Nocera Inferiore Mercato	NOCERA INFERIORE MERCATO
Nocera Superiore	NOCERA SUPERIORE
Nocera Tirinese	NOCERA TIRINESE
Nocera Umbra	NOCERA UMBRA
Noceto	NOCETO
Nogara	NOGARA
Nola	NOLA
None	NONE
Notaresco	NOTARESCO
Noto	NOTO
Nova Siri Rotondella	NOVA SIRI-ROTONDELLA
Novara	NOVARA
Novara Montalbano Furnari	NOVARA-MONTALBANO-FURNARI
Novate-Mezzola	NOVATE MEZZOLA
Nove	NOVE
Novi Ligure	NOVI LIGURE
Nozzano	NOZZANO
Nucetto	NUCETTO
Nuovo Salario	NUOVO SALARIO
Nus	NUS
Nusco	NUSCO
Occhiobello	OCCHIOBELLO
Oderzo	ODERZO
Offida Castel Di Lama	OFFIDA-CASTEL DI LAMA
Oggiono	OGGIONO
Olbia	OLBIA
Olbia Marittima Isola Bianca	
Olcenengo	OLCENENGO
Olcio	OLCIO
Oleggio	OLEGGIO
Olevano	OLEVANO
Olgiata	OLGIATA
Olgiate-Calco-Brivio	OLGIATE-CALCO-BRIVIO
Oliveri Tindari	OLIVERI-TINDARI
Olivetta San Michele	OLIVETTA S. MICHELE
Olmeneta	OLMENETA
Olmi Spercenigo	OLMI SPERCENIGO
Omegna	OMEGNA
Omegna Crusinallo	OMEGNA-CRUSINALLO
Omignano Salento	OMIGNANO-SALENTO
Ora	ORA AUER
Orbetello	ORBETELLO-MONTE ARGENTARIO
Orciano	ORCIANO
Ordona	ORDONA
Oria	ORIA
Oricola-Pereto	ORICOLA-PERETO
Orio Litta	ORIO LITTA
Oriolo	ORIOLO
Oris	ORIS EYRS
Oristano	ORISTANO
Ornavasso	ORNAVASSO
Orsa	ORSA
Orsago	ORSAGO
Orsara Di Puglia	ORSARA DI PUGLIA
Orta Miasino	ORTA-MIASINO
Ortanova	ORTANOVA
Orte	ORTE
Ortona	ORTONA
Orvieto	ORVIETO
Oschiri	OSCHIRI
Osimo Castelfidardo	OSIMO-CASTELFIDARDO
Osnago	OSNAGO
Ospedaletto Euganeo	OSPEDALETTO EUGANEO
Ospedaletto Lodigiano	OSPEDALETTO LODIGIANO
Ospedalicchio	OSPEDALICCHIO
Ospitale Di Cadore	OSPITALE DI CADORE
Ospitaletto Mantovano	OSPITALETTO MANTOVANO
Ospitaletto Travagliato	OSPITALETTO-TRAVAGLIATO
Osteria Nuova	OSTERIA NUOVA
Ostia Parmense	OSTIA PARMENSE
Ostiglia	OSTIGLIA
Ostuni	OSTUNI
Ottaviano	OTTAVIANO
Oulx Cesana Claviere Sestriere	OULX-CESANA-CLAVIERE-SESTRIERE
Ovada	OVADA
Ovada Nord	OVADA NORD
Oviglio	OVIGLIO
Ozieri Chilivani	OZIERI-CHILIVANI
Ozieri Fraigas	
Ozzano Dell'Emilia	OZZANO
Ozzano Monferrato	OZZANO MONFERRATO
Ozzano Taro	OZZANO TARO
Palermo Centrale	PALERMO CENTRALE
Palermo C.le	PALERMO CENTRALE
P.C.Canaro	CANARO
P.M. Badesse	BADESSE
P.M.Vat	
Pabillonis	PABILLONIS
Pace Del Mela	PACE DEL MELA
Paceco	PACECO
Pachino	PACHINO
Paderno Robbiate	PADERNO-ROBBIATE
Padiglione	PADIGLIONE
Padova	PADOVA
Padula	PADULA
Paduli	PADULI SUL CALORE
Paese	PAESE
Paese Castagnole	PAESE-CASTAGNOLE
Paestum	PAESTUM
Pagani	PAGANI
Paganica	PAGANICA
Palagianello	PALAGIANELLO
Palagiano Chiatona	PALAGIANO-CHIATONA
Palagiano Mottola	PALAGIANO-MOTTOLA
Palagonia	PALAGONIA
Palazzo Reale-Orleans	PALERMO PALAZZO REALE-ORLEANS
Palazzo S.Gervasio - Montemil.	PALAZZO S. GERVASIO-MONTEMILONE
Palazzolo Dello Stella	PALAZZOLO DELLO STELLA
Palazzolo Sull`Oglio	PALAZZOLO SULL'OGLIO
Palazzolo Vercellese	PALAZZOLO VERCELLESE
Palena	PALENA
Palermo Brancaccio	PALERMO BRANCACCIO
Palermo Notarbartolo	PALERMO NOTARBARTOLO
Palestro	PALESTRO
Palidano	PALIDANO
Palizzi	PALIZZI
Pallanzeno	PALLANZENO
Pallerone	PALLERONE
Palma S.Gennaro	PALMA-S. GENNARO
Palmanova	PALMANOVA
Palmi	PALMI
Palo Laziale	PALO LAZIALE
Palombina	PALOMBINA
Panicaglia	PANICAGLIA
Pantiere Di Castelbellino	PANTIERE DI CASTELBELLINO
Paola	PAOLA
Parabiago	PARABIAGO
Paratico Sarnico	PARATICO SARNICO
Parco Leonardo	PARCO LEONARDO
Parghelia	PARGHELIA
Parma	PARMA
Parona Lomellina	PARONA LOMELLINA
Partinico	PARTINICO
Passignano Sul Trasimeno	PASSIGNANO SUL TRASIMENO
Paternopoli	PATERNOPOLI
Patti-San Piero Patti	PATTI-S. PIERO PATTI
Paulilatino	PAULILATINO
Pavia	PAVIA
Pavia Porta Garibaldi	PAVIA PORTA GARIBALDI
Pavona	PAVONA
Pedaso	PEDASO
Pederobba Cavaso Possagno	PEDEROBBA-CAVASO-POSSANGO
Pellezzano	PELLEZZANO
Penango	PENANGO
Perarolo Di Cadore	PERAROLO DI CADORE
Pergine	PERGINE
Pergola	PERGOLA
Peri	PERI
Pertengo	PERTENGO
Perugia	PERUGIA
Perugia Ponte S.Giovanni	PERUGIA PONTE S. GIOVANNI
Pesaro	PESARO
Pescara	PESCARA CENTRALE
Pescara Porta Nuova	PESCARA PORTA NUOVA
Pescara S. Marco	PESCARA S.MARCO
Peschiera Del Garda	PESCHIERA DEL GARDA
Pescia	PESCIA
Pescina	PESCINA
Pescocanale	PESCOCANALE
Pescolanciano-Chiauci	PESCOLANCIANO-CHIAUCI
Pescosannita Fragneto L`Abate	PESCOSANNITA-FRAGNETO L'ABATE
Pessione	PESSIONE
Petina	PETINA
Petrosino Strasatti	PETROSINO-STRASATTI
Pettenasco	PETTENASCO
Pettorano Sul Gizio	PETTORANO SUL GIZIO
Piacenza	PIACENZA
Piadena	PIADENA
Pian Del Mugnone	PIAN DEL MUGNONE
Pian Di Venola	PIAN DI VENOLA
Piana	PIANA
Piana Bella Montelibretti	PIANA BELLA DI MONTELIBRETTI
Piana Del Signore	PIANA DEL SIGNORE
Pianerottolo Di Ariano	PIANEROTTOLO D'ARIANO
Pianfei	PIANFEI
Piano D`Orta Bolognano	PIANO D'ORTA BOLOGNANO
Piano Orizzontale Dei Giovi	PIANO ORIZZONTALE DEI GIOVI
Pianoro	PIANORO
Pianzano	PIANZANO
Piazza Al Serchio	PIAZZA AL SERCHIO
Piazza Amedeo	NAPOLI PIAZZA AMEDEO
Piazza Cavour	NAPOLI PIAZZA CAVOUR
Picerno	PICERNO
Piedimulera	PIEDIMULERA
Pietra Ligure	PIETRA LIGURE
Pietrabissara	PIETRABISSARA
Pietragalla	PIETRAGALLA
Pietrapaola	PIETRAPAOLA
Pietrarsa	PIETRARSA-S. GIORGIO A CREMANO
Pietrasanta	PIETRASANTA
Pietrelcina	PIETRELCINA
Pieve Albignola	PIEVE ALBIGNOLA
Pieve Ligure	PIEVE LIGURE
Pieve Vergonte	PIEVE VERGONTE
Pievetta	PIEVETTA
Pignataro Maggiore	PIGNATARO MAGGIORE
Pinarolo Po	PINAROLO PO
Pinerolo	PINEROLO
Pinerolo Olimpica	PINEROLO OLIMPICA
Pineto	PINETO-ATRI
Pineto Atri	PINETO-ATRI
Pinzano	PINZANO
Pioltello Limito	PIOLTELLO-LIMITO
Piombino	PIOMBINO
Piombino Binari Mare	PIOMBINO MARITTIMA
Piombino Dese	PIOMBINO DESE
Piona	PIONA
Pioppe Di Salvaro	PIOPPE DI SALVARO
Piraineto	PIRAINETO
Pisa Binari Aeroporto	PISA FERMATA AEROPORTO
Pisa Centrale	PISA CENTRALE
Pisa C.le	PISA CENTRALE
Pisa San Rossore	PISA S. ROSSORE
Piscina Di Pinerolo	PISCINA DI PINEROLO
Pisciolo	PISCIOLO
Pisciotta Palinuro	PISCIOTTA-PALINURO
Pisticci	PISTICCI
Pistoia	PISTOIA
Piteccio	PITECCIO
Pizzighettone	PIZZIGHETTONE GERA
Pizzo	PIZZO
Plaus	PLAUS PLAUS
Ploaghe	PLOAGHE
Pocapaglia	POCAPAGLIA
Poggibonsi	POGGIBONSI-S. GIMIGNANO
Poggio - Careggine - Vagli	POGGIO-CAREGGINE-VAGLI
Poggio Fidoni	POGGIO FIDONI
Poggio Imperiale	POGGIO IMPERIALE
Poggio Mirteto	POGGIO MIRTETO
Poggio Renatico	POGGIO RENATICO
Poggio Rusco	POGGIO RUSCO
Poggiorsini	POGGIORSINI
Poggiridenti-Tresivio-Piateda	POGGIRIDENTI-TRESIVIO-PIATEDA
Pogliola	POGLIOLA
Polesella	POLESELLA
Policastro Bussentino	POLICASTRO BUSSENTINO
Policoro Tursi	POLICORO-TURSI
Polignano A Mare	POLIGNANO A MARE
Polla	POLLA
Pollenza	POLLENZA
Pollina	POLLINA-S. MAURO CASTELVERDE
Pombia	POMBIA
Pomezia - S.Palomba	POMEZIA-S. PALOMBA
Pompei	POMPEI
Pont	PONT CANAVESE
Pont Saint Martin	PONT SAINT MARTIN
Pontassieve	PONTASSIEVE
Ponte A Elsa	PONTE A ELSA
Ponte A Moriano	PONTE A MORIANO
Ponte A Tressa	PONTE A TRESSA
Ponte Albanito	PONTE ALBANITO
Ponte Casalduni	PONTE-CASALDUNI
Ponte Della Venturina	PONTE DELLA VENTURINA
Ponte Di Brenta	PONTE DI NONA
Ponte Di Piave	PONTE DI PIAVE
Ponte D`Adda	PIZZIGHETTONE-PONTE D'ADDA
Ponte D`Adige	PONTE D'ADIGE SIGMUNDSKRON
Ponte Galeria	PONTE GALERIA
Ponte Gardena	PONTE GARDENA LAION/WAIDBRUCK LAJEN
Ponte Ginori	PONTE GINORI
Ponte In Valtellina	PONTE IN VALTELLINA
Ponte Nelle Alpi-Polpet	PONTE NELLE ALPI-POLPET
Ponte Parrano Di Nocera Umbra	PONTE PARRANO DI NOCERA UMBRA
Ponte S.Marco - Calcinato	PONTE S. MARCO-CALCINATO
Ponte S.Pietro	PONTE S. PIETRO
Pontebba	PONTEBBA
Pontecagnano	PONTECAGNANO
Pontecchio Marconi	PONTECCHIO MARCONI
Pontecurone	PONTECURONE
Pontedera Casciana Terme	PONTEDERA-CASCIANA TERME
Pontelagoscuro	PONTELAGOSCURO
Pontelandolfo	PONTELANDOLFO
Pontenure	PONTENURE
Pontetto	PONTETTO
Ponti	PONTI
Ponticino	PONTICINO
Pontida	PONTIDA
Pontremoli	PONTREMOLI
Ponzana	PONZANA
Ponzano Magra	PONZANO MAGRA
Popolano	POPOLANO DI MARRADI
Popoli Vittorito	POPOLI-VITTORITO
Populonia	POPULONIA
Porcari	PORCARI
Pordenone	PORDENONE
Porretta  Terme	PORRETTA TERME
Portacomaro	PORTACOMARO
Portici- Ercolano	PORTICI-ERCOLANO
Porto Ceresio	PORTO CERESIO
Porto Di Vasto	PORTO DI VASTO
Porto D`Ascoli	PORTO D'ASCOLI
Porto Empedocle	PORTO EMPEDOCLE CENTRALE
Porto Recanati	PORTO RECANATI
Porto S. Elpidio	PORTO S.ELPIDIO
Porto S. Giorgio Fermo	PORTO S. GIORGIO-FERMO
Porto Torres	PORTO TORRES
Porto Valtravaglia	PORTO VALTRAVAGLIA
Porto Varallo Pombia	PORTO VARALLO POMBIA
Portogruaro Caorle	PORTOGRUARO-CAORLE
Portomaggiore	PORTOMAGGIORE
Possidente	POSSIDENTE
Postioma	POSTIOMA
Posto Comunicazione Dolce`	DOLCE
Potenza Inferiore	POTENZA CENTRALE
Potenza Picena Montelupone	POTENZA PICENA-MONTELUPONE
Potenza Superiore	POTENZA SUPERIORE
Pove Del Grappa Campese	POVE DEL GRAPPA-CAMPESE
Pozzallo	POZZALLO
Pozzolo Formigaro	POZZOLO FORMIGARO
Pozzuoli Solfatara	POZZUOLI SOLFATARA
Pozzuolo Martesana	POZZUOLO MARTESANA
Pracchia	PRACCHIA
Praja Ajeta Tortora	PRAJA-AJETA-TORTORA
Prasco Cremolino	PRASCO-CREMOLINO
Prata Pratola	PRATA-PRATOLA
Pratignone	PRATIGNONE
Prato Borgonuovo	PRATO BORGONUOVO
Prato Centrale	PRATO CENTRALE
Prato C.le	PRATO CENTRALE
Prato Porta Al Serraglio	PRATO PORTA AL SERRAGLIO
Prato Sesia	PRATO SESIA
Pratola Peligna	PRATOLA PELIGNA
Pratola Peligna Superiore	PRATOLA PELIGNA SUPERIORE
Predosa	PREDOSA
Preganziol	PREGANZIOL
Pregnana Milanese	PREGNANA MILANESE
Premosello Chiovenda	PREMOSELLO-CHIOVENDA
Prezza	PREZZA
Pre` Saint Didier	PRE SAINT DIDIER
Primolano	PRIMOLANO
Priola	PRIOLA
Priolo Melilli	PRIOLO-MELILLI
Priolo Soprano	PRIOLO SOPRANO
Priverno Fossanova	PRIVERNO-FOSSANOVA
Punta Raisi	PUNTA RAISI
Quarona	QUARONA
Quart	QUART
Quarto Di Marano	QUARTO DI MARANO
Quarto D`Altino	QUARTO D'ALTINO
Quattro Venti	QUATTRO VENTI
Quercianella	QUERCIANELLA-SONNINO
Quero Vas	QUERO-VAS
Quiliano Vado	QUILIANO-VADO LIGURE
Quincinetto	QUINCINETTO
Roma Termini	ROMA TERMINI
R.C.Aeroporto	REGGIO DI CALABRIA AEROPORTO
Racalmuto	RACALMUTO
Racconigi	RACCONIGI
Ragusa	RAGUSA
Ragusa Ibla	RAGUSA IBLA
Raiano	RAIANO
Randazzo	RANDAZZO
Rapallo	RAPALLO
Rapolano Terme	RAPOLANO TERME
Rapone Ruvo S.Fele	RAPONE-RUVO-SAN FELE
Rastignano	RASTIGNANO
Ravenna	RAVENNA
Recale	RECALE
Recco	RECCO
Redipuglia	REDIPUGLIA
Reggio Calabria Centrale	REGGIO DI CALABRIA CENTRALE
Reggio C. C.le	REGGIO DI CALABRIA CENTRALE
Reggio Calabria Lido	REGGIO DI CALABRIA LIDO
Reggio C. Lido	REGGIO DI CALABRIA LIDO
Reggio Di Calabria Catona	REGGIO DI CALABRIA CATONA
Reggio Di Calabria Gallico	REGGIO DI CALABRIA GALLICO
Reggio Di Calabria Pellaro	REGGIO DI CALABRIA PELLARO
Reggio Di Calabria S.Gregorio	REGGIO DI CALABRIA S. GREGORIO
Reggio Emilia	REGGIO EMILIA
Reggio Emilia Av	REGGIO EMILIA AV
Regoledo	REGOLEDO
Remedello Sopra	REMEDELLO SOPRA
Remedello Sotto	REMEDELLO SOTTO
Renate-Veduggio	RENATE-VEDUGGIO
Resana	RESANA
Revere	REVERE
Reviglione Di Somma Vesuviana	REVIGLIONE DI SOMMA VESUVIANA
Rho	RHO
Rho Fiera Milano	RHO-FIERA MILANO
Riace	RIACE
Riardo	RIARDO-PIETRAMELARA
Ricadi	RICADI
Riccione	RICCIONE
Rieti	RIETI
Rignano Garganico	RIGNANO GARGANICO
Rignano Sull`Arno Reggello	RIGNANO SULL'ARNO-REGGELLO
Rigoli	RIGOLI
Rigomagno	RIGOMAGNO
Rigoroso	RIGOROSO
Rimini	RIMINI
Rimini Miramare	RIMINI MIRAMARE
Rimini Torre Pedrera	RIMINI TORRE PEDRERA
Rimini Viserba	RIMINI VISERBA
Rio Di Pusteria	RIO DI PUSTERIA
Rio Secco	RIO SECO
Riofreddo	RIOFREDDO
Riola	RIOLA
Riomaggiore	RIOMAGGIORE
Rionero Atella Ripacandita	RIONERO-ATELLA-RIPACANDIDA
Ripabottoni S.Elia	RIPABOTTONI-S. ELIA
Ripafratta	RIPAFRATTA
Riparbella	RIPARBELLA
Risano	RISANO
Riva Trigoso	RIVA TRIGOSO
Rivalta Scrivia	RIVALTA SCRIVIA
Rivisondoli-Pescocostanzo	RIVISONDOLI-PESCOCOSTANZO
Robbio	ROBBIO
Robecco-Pontevico	ROBECCO-PONTEVICO
Robilante	ROBILANTE
Rocca Di Corno	ROCCA DI CORNO
Rocca Di Fondi	ROCCA DI FONDI
Rocca D`Evandro	ROCCA D'EVANDRO-S. VITTORE
Rocca Imperiale	ROCCA IMPERIALE
Rocca Ravindola	ROCCA RAVINDOLA
Roccabernarda	ROCCABERNARDA
Roccaciglie`	ROCCACIGLIE
Roccadebaldi	ROCCADEBALDI
Roccagrimalda	ROCCAGRIMALDA
Roccalumera Mandanici	ROCCALUMERA-MANDANICI
Roccamurata	ROCCAMURATA
Roccapalumba-Alia	ROCCAPALUMBA-ALIA
Roccaraso	ROCCARASO
Roccasecca	ROCCASECCA
Roccastrada	ROCCASTRADA
Roccavione	ROCCAVIONE
Roccella Jonica	ROCCELLA JONICA
Rocchetta Cairo	ROCCHETTA CAIRO
Rocchetta S.Ant.Lac.	ROCCHETTA S. ANTONIO-LACEDONIA
Rocchetta Tanaro Cerro	ROCCHETTA TANARO-CERRO
Rodallo	RODALLO
Rogolo	ROGOLO
Rolo Novi Fabbrico	ROLO-NOVI-FABBRICO
Roma Aurelia	ROMA AURELIA
Roma Casilina	ROMA CASILINA
Roma Monte Mario	ROMA MONTE MARIO
Roma Nomentana L.L.	ROMA NOMENTANA
Roma Ostiense	ROMA OSTIENSE
Roma Prenestina	ROMA PRENESTINA
Roma S.Filippo Neri	ROMA S. FILIPPO NERI
Roma S.Pietro	ROMA S. PIETRO
Roma Tiburtina	ROMA TIBURTINA
Roma Tiburtina Piazzale Est	ROMA TIBURTINA
Roma Trastevere	ROMA TRASTEVERE
Roma Tuscolana	ROMA TUSCOLANA
Romagnano Sesia	ROMAGNANO SESIA
Romagnano V.	ROMAGNANO-VIETRI-SALVITELLE
Romano	ROMANO
Romanore	ROMANORE
Rometta Messinese	ROMETTA MESSINESE
Roncanova Di Gazzo Ver.	RONCANOVA DI GAZZO VERONESE
Roncegno Bagni-Marter	RONCEGNO BAGNI-MARTER
Ronchi Dei Legionari Nord	RONCHI DEI LEGIONARI NORD
Ronciglione	RONCIGLIONE
Ronco Scr.	RONCO SCRIVIA
Ronta	RONTA
Rosarno	ROSARNO
Rosa`	ROSA
Roseto Capo Spulico	ROSETO-CAPO SPULICO
Roseto Degli Abruzzi	ROSETO DEGLI ABRUZZI
Rosignano	ROSIGNANO
Rosolina	ROSOLINA
Rosolini	ROSOLINI
Rossano	ROSSANO
Rossano Veneto	ROSSANO VENETO
Rossiglione	ROSSIGLIONE
Rosta	ROSTA
Rottofreno	ROTTOFRENO
Rovasenda	ROVASENDA
Rovasenda Alta	
Rovato	ROVATO
Roverbella	ROVERBELLA
Rovereto	ROVERETO
Roviano	ROVIANO
Rovigo	ROVIGO
Rubiera	RUBIERA
Rudalza	RUDALZA
Rufina	RUFINA
Russi	RUSSI
Rutino	RUTINO
S. Ambrogio	S. AMBROGIO
S. Antonino Di Saluggia	S. ANTONINO DI SALUGGIA
S. Antonino Vaie	S. ANTONINO-VAIE
S. Cassiano Valchiavenna	S. CASSIANO VALCHIAVENNA
S. Cristina E Bissone	S. CRISTINA E BISSONE
S. Damiano D`Asti	S. DAMIANO D'ASTI
S. Dona` Di Piave	S. DONA' DI PIAVE-JESOLO
S. Eurosia	S. EUROSIA
S. Germano Vercellese	S. GERMANO VERCELLESE
S. Giacomo Di Teglio	S. GIACOMO DI TEGLIO
S. Giovanni In Croce	S. GIOVANNI IN CROCE
S. Giuliano Milanese	S. GIULIANO MILANESE
S. Giuliano Piacentino	S. GIULIANO PIACENTINO
S. Margherita Ligure Portofino	S. MARGHERITA LIGURE-PORTOFINO
S. Maria Delle Mole	S. MARIA DELLE MOLE
S. Nicola Di Melfi	S. NICOLA DI MELFI
S. Paolo Solbrito	S. PAOLO SOLBRITO
S. Pietro A Vico	S. PIETRO A VICO
S. Pietro Avellana-Capracotta	S. PIETRO AVELLANA-CAPRACOTTA
S. Pietro Berbenno	S. PIETRO-BERBENNO
S. Pietro Vernotico	S. PIETRO VERNOTICO
S. Stefano Di Magra	S. STEFANO DI MAGRA
S. Stino Di Livenza	S. STINO DI LIVENZA
S. Vincenzo	S. VINCENZO
S. Zeno Folzano	S. ZENO-FOLZANO
S. Zenone Al Lambro	S. ZENONE AL LAMBRO
S.Agata M.	S. AGATA DI MILITELLO
S.Agata Sul Santerno	S. AGATA SUL SANTERNO
S.Alessio Siculo Forza D`Agro`	S. ALESSIO SICULO-FORZA D'AGRO'
S.Andrea Dell`Jonio	S. ANDREA DELLO JONIO
S.Angelo Dei Lombardi	S. ANGELO DEI LOMBARDI
S.Anna Robella	S. ANNA ROBELLA
S.Antimo S.Arpino	S. ANTIMO-S. ARPINO
S.Antonio Mantovano	S. ANTONIO MANTOVANO
S.Arcangelo Di Romagna	SANTARCANGELO DI ROMAGNA
S.Benedetto Del Tronto	S. BENEDETTO DEL TRONTO
S.Benigno Di Cuneo	S. BENIGNO DI CUNEO
S.Biagio	S. BIAGIO
S.Biagio Di Callalta	S. BIAGIO DI CALLALTA
S.Candido	S. CANDIDO INNICHEN
S.Cassiano	S. CASSIANO
S.Cataldo	S. CATALDO
S.Caterina Dell`Jonio	S. CATERINA DELLO JONIO
S.Claudio	S. CLAUDIO
S.Cristoforo Al Lago-Ischia	S. CRISTOFORO AL LAGO-ISCHIA
S.Croce Del Lago	SANTA CROCE DEL LAGO
S.Croce Del Sannio	S. CROCE DEL SANNIO
S.Demetrio De` Vestini	S. DEMETRIO DE' VESTINI
S.Donnino Badia	S. DONNINO
S.Elena - Este	S. ELENA-ESTE
S.Ellero	S. ELLERO
S.Felice Sp	S. FELICE SUL PANARO
S.Filippo	S. FILIPPO
S.Filippo-S.Lucia	S. FILIPPO-S. LUCIA
S.Flavia	S. FLAVIA-SOLUNTO-PORTICELLO
S.Frediano A Settimo	S. FREDIANO A SETTIMO
S.Giacomo Di Spoleto	S. GIACOMO DI SPOLETO
S.Giorgio Casale	S. GIORGIO CASALE
S.Giorgio Delle Pertiche	S. GIORGIO DELLE PERTICHE
S.Giorgio P.	S. GIORGIO DI PIANO
S.Giovanni Al Natisone	S. GIOVANNI AL NATISONE
S.Giovanni Di Casarsa	S. GIOVANNI DI CASARSA
S.Giovanni D`Asso	S. GIOVANNI D'ASSO
S.Giovanni Valdarno	S. GIOVANNI VALDARNO
S.Giuletta	S. GIULETTA
S.Giuliano Piemonte	S. GIULIANO PIEMONTE
S.Giuliano Terme	S. GIULIANO TERME
S.Giuseppe Vesuviano	S. GIUSEPPE VESUVIANO
S.Giustina Cesio	S. GIUSTINA-CESIO
S.Ilario	S. ILARIO D'ENZA
S.Liberato	S. LIBERATO
S.Lorenzo Colli	PALERMO S. LORENZO
S.Lorenzo Maggiore	S. LORENZO MAGGIORE
S.Lucido Marina	S. LUCIDO MARINA
S.Marcellino Frignano	S. MARCELLINO-FRIGNANO
S.Marco Roggiano	S. MARCO-ROGGIANO
S.Maria Capua Vetere	S. MARIA CAPUA VETERE
S.Maria La Bruna	SANTA MARIA LA BRUNA
S.Maria La Longa	S. MARIA LA LONGA
S.Maria Oliveto	S. MARIA OLIVETO
S.Marino	S. MARINO
S.Martino Al Cimino	S. MARTINO AL CIMINO
S.Martino Buon Albergo	S. MARTINO BUONALBERGO
S.Martino Di Lupari	S. MARTINO DI LUPARI
S.Martino In Gattara	S. MARTINO IN GATTARA
S.Martino In Pensilis	S. MARTINO IN PENSILIS
S.Michele Di Serino	S. MICHELE DI SERINO
S.Michele In Bosco	S. MICHELE IN BOSCO
S.Miniato Fucecchio	S. MINIATO-FUCECCHIO
S.Nazario	S. NAZARIO
S.Nicola Arcella	S. NICOLA ARCELLA
S.Nicola T.	S. NICOLA (TONNARA)
S.Nicolo'	S. NICOLO'
S.Piero A Sieve	S. PIERO A SIEVE
S.Pietro A Maida	S. PIETRO A MAIDA-MAIDA
S.Pietro In Casale	S. PIETRO IN CASALE
S.Pietro In Gu`	S. PIETRO IN GU
S.Romano Montopoli S.Croce	S. ROMANO-MONTOPOLI-S. CROCE
S.Sebastiano Po	S. SEBASTIANO PO
S.Severino Marche	S. SEVERINO MARCHE
S.Silvestro	
S.Stefano Belbo	S. STEFANO BELBO
S.Stefano Lodigiano	S. STEFANO LODIGIANO
S.Stefano Udinese	S. STEFANO UDINESE
S.Tommaso Del Piano	S. TOMMASO DEL PIANO
S.Vincenzo V.R.	S. VINCENZO VALLE ROVETO
S.Vito Al Tagliamento	S. VITO AL TAGLIAMENTO
S.Vito Dei Normanni	S. VITO DEI NORMANNI
S.Vito Lanciano	S. VITO-LANCIANO
S.Vittoria	S. VITTORIA
Sacile	SACILE
Sacile San Liberale	SACILE-S. LIBERALE
Sagrado	SAGRADO
Saint Pierre	SAINT PIERRE
Sairano	SAIRANO
Sairano Zinasco	SAIRANO-ZINASCO
Sala Al Barro-Galbiate	SALA AL BARRO-GALBIATE
Sala Consilina	SALA CONSILINA
Salandra	SALANDRA-GROTTOLE
Salbertrand	SALBERTRAND
Sale Langhe	SALE LANGHE
Salemi Gibellina	SALEMI-GIBELLINA
Salerno	SALERNO
Saletto	SALETTO
Saliceto	SALICETO
Saline Di Reggio	SALINE DI REGGIO
Salone	SALONE
Salorno	SALORNO SALURN
Salsomaggiore T.	SALSOMAGGIORE TERME
Saluggia	SALUGGIA
Salussola	SALUSSOLA
Salza Irpina	SALZA IRPINA
Salzano Robegano	SALZANO-ROBEGANO
Samassi Serrenti	SAMASSI-SERRENTI
Samoggia	SAMOGGIA
Samolaco	SAMOLACO
Sampieri	SAMPIERI
San Benedetto Sambro-Cast.Pepoli	SAN BENEDETTO SAMBRO-CASTIGLIONE P.
San Bonifacio	S. BONIFACIO
San Gavino	S. GAVINO
San Giacomo	S. GIACOMO
San Giorgio	S. GIORGIO
San Giorgio Di Nogaro	S. GIORGIO DI NOGARO
San Giovanni	
San Giovanni In Persiceto	S. GIOVANNI IN PERSICETO
San Giuseppe Di Cairo	S. GIUSEPPE DI CAIRO
San Leonardo Di Cutro	S. LEONARDO DI CUTRO
San Marco D`Alunzio T.	S. MARCO D'ALUNZIO-TORRENOVA
San Mauro La Bruca	S. MAURO LA BRUCA
San Momme`	S. MOMME'
San Nicola Varco Di Eboli	S. NICOLA VARCO DI EBOLI
San Remo	SANREMO
San Severo	S. SEVERO
Sandigliano	SANDIGLIANO
Sanfre`	SANFRE
Sangiano	SANGIANO
Sangineto	SANGINETO
Sanguinetto	SANGUINETTO
Sanluri Stato	SANLURI STATO
Sannazzaro	SANNAZZARO
Sannicandro Di Bari	SANNICANDRO DI BARI
Santa Domenica	SANTA DOMENICA
Santa Luce	SANTA LUCE
Santa Maria Di Catanzaro	S. MARIA DI CATANZARO
Santa Marinella	S. MARINELLA
Santa Severa	SANTA SEVERA
Santa Teresa Di Riva	S. TERESA DI RIVA
Sante Marie	SANTE MARIE
Santeramo	SANTERAMO
Santhia`	SANTHIA
Santo Stefano Di Camastra	S. STEFANO DI CAMASTRA-MISTRETTA
Santuario	SANTUARIO
Santuario Incoronata	SANTUARIO INCORONATA
Sant`Anna	S. ANNA
Sant`Orsola	
Sanzano Occhino	SANZANO-OCCHINO
Sapri	SAPRI
Sarmato	SARMATO
Sarno	SARNO
Saronno	SARONNO
Sarre	SARRE
Sartirana	SARTIRANA
Sarzana	SARZANA
Sassa Tornimparte	SASSA-TORNIMPARTE
Sassano Teggiano	SASSANO-TEGGIANO
Sassari	SASSARI
Sasso Marconi	SASSO MARCONI
Sassoferrato Arcevia	SASSOFERRATO-ARCEVIA
Sassone	SASSONE
Savigliano	SAVIGLIANO
Savignano Greci	SAVIGNANO-GRECI
Savignano Sul Rubicone	SAVIGNANO SUL RUBICONE
Savona	SAVONA
Savona Marittima	
Scafa S.Valentino Caramanico T	SCAFA-S. VALENTINO-CARAMANICO TERME
Scafati	SCAFATI
Scala Di Giocca	
Scalea S.Domenica Talao	SCALEA-S. DOMENICA TALAO
Scalenghe	SCALENGHE
Scaletta Zanclea	SCALETTA ZANCLEA
Scanzano Belfiore	SCANZANO-BELFIORE
Scanzano J. Montalbano J.	SCANZANO JONICO-MONTALBANO JONICO
Scarlino	SCARLINO
Scerne Di Pineto	SCERNE DI PINETO
Schio	SCHIO
Scicli	SCICLI
Scilla	SCILLA
Scopeti	SCOPETI
Scorcetoli	SCORCETOLI
Scordia	SCORDIA
Scurcola Marsicana	SCURCOLA MARSICANA
Secugnago	SECUGNAGO
Sedico Bribano	SEDICO-BRIBANO
Segesta Tempio	SEGESTA TEMPIO
Segrate	SEGRATE
Sella Di Corno	SELLA DI CORNO
Sellia Marina	SELLIA MARINA
Selva Del Bocchetto	SELVA DEL BOCCHETTO
Senigallia	SENIGALLIA
Sepino	SEPINO
Seregno	SEREGNO
Seriate	SERIATE
Serino	SERINO
Serra S.Quirico	SERRA S. QUIRICO
Serradifalco	SERRADIFALCO
Serralunga Cereseto	SERRALUNGA-CERESETO
Serramanna Nuraminis	SERRAMANNA-NURAMINIS
Serravalle	SERRAVALLE ALL'ADIGE
Serravalle D`Asti	SERRAVALLE D'ASTI
Serravalle Pistoiese	SERRAVALLE PISTOIESE
Serravalle Scrivia	SERRAVALLE SCRIVIA
Serre Di Rapolano	SERRE DI RAPOLANO
Sessa Aurunca R.	SESSA AURUNCA-ROCCAMONFINA
Sessano Del Molise	SESSANO DEL MOLISE
Sesto Calende	SESTO CALENDE
Sesto Campano	SESTO CAMPANO
Sesto Fiorentino	SESTO FIORENTINO
Sesto S. Giovanni	SESTO S. GIOVANNI
Sestri Levante	SESTRI LEVANTE
Sette Bagni	SETTEBAGNI
Settequerce	SETTEQUERCE SIEBENEICH
Settime Cinaglio Mombarone	SETTIME-CINAGLIO-MOMBARONE
Settimo	SETTIMO
Settimo Tavagnasco	SETTIMO-TAVAGNASCO
Settingiano	SETTINGIANO
Sevegliano	SEVEGLIANO
Seveso	SEVESO
Sezze Romano	SEZZE ROMANO
Sgurgola	SGURGOLA
Sibari	SIBARI
Sicignano Degli Alburni	SICIGNANO DEGLI ALBURNI
Siderno	SIDERNO
Sieci	SIECI
Siena	SIENA
Siena Zona Industriale	SIENA ZONA INDUSTRIALE
Signa	SIGNA
Silandro	SILANDRO SCHLANDERS
Siliqua	SILIQUA
Silla	SILLA
Sillavengo	SILLAVENGO
Silvi	SILVI
Simeri Crichi	SIMERI-CRICHI
Sinalunga	SINALUNGA
Sipicciano	SIPICCIANO
Siponto	SIPONTO
Siracusa	SIRACUSA
Siracusa M.	SIRACUSA
Sistiana	SISTIANA-VISOGLIANO
Sizzano	SIZZANO
Sluderno-Glorenza	SLUDERNO-GLORENZA SCHLUDERNS-GLURNS
Soffratta	SOFFRATTA
Solagna	SOLAGNA
Solarolo	SOLAROLO
Solarussa	SOLARUSSA
Solero	SOLERO
Soliera Modenese	SOLIERA MODENESE
Solignano	SOLIGNANO
Solofra	SOLOFRA
Solopaca	SOLOPACA
Somma Lombardo	SOMMA LOMBARDO
Sommariva Bosco	SOMMARIVA DEL BOSCO
Sondrio	SONDRIO
Sora	SORA
Soresina	SORESINA
Sorgenti Del Peschiera	SORGENTI DEL PESCHIERA
Sori	SORI
Soverato	SOVERATO
Spadafora	SPADAFORA
Spagnuola	SPAGNUOLA
Sparanise	SPARANISE
Spartimento Di Scisciano	SPARTIMENTO DI SCISCIANO
Spello	SPELLO
Spezzano Albanese Terme	SPEZZANO ALBANESE TERME
Spigno	SPIGNO
Spinazzola	SPINAZZOLA
Spinetoli Colli	SPINETOLI-COLLI
Spinetta	SPINETTA
Spoleto	SPOLETO
Spondigna-Prato Venosta	SPONDINGA-PRATO SPONDINIG-PRAD
Spotorno Noli	SPOTORNO-NOLI
Spresiano	SPRESIANO
Squillace	SQUILLACE
Squinzano	SQUINZANO
Stanghella	STANGHELLA
Stazione Per L`Alpago	STAZIONE PER L'ALPAGO
Sticciano	STICCIANO
Stimigliano	STIMIGLIANO
Strada Casale	STRADA CASALE
Stradella	STRADELLA
Strambino	STRAMBINO
Strassoldo	STRASSOLDO
Stresa	STRESA
Strevi	STREVI
Strigno	STRIGNO
Stroncone	STRONCONE
Strongoli	STRONGOLI
Su Canale	SU CANALE
Sulmona	SULMONA
Sulmona-Introdacqua	SULMONA-INTRODACQUA
Suno	SUNO
Susa	SUSA
Susegana	SUSEGANA
Suzzara	SUZZARA
Torino P.Nuova	TORINO PORTA NUOVA
Taggia Arma	TAGGIA ARMA
Tagliacozzo	TAGLIACOZZO
Taino Angera	TAINO-ANGERA
Talamona	TALAMONA
Talamone	TALAMONE
Taormina	TAORMINA-GIARDINI
Taranto	TARANTO
Tarcento	TARCENTO
Targia	TARGIA
Tarquinia	TARQUINIA
Tarsia	TARSIA
Tarvisio Boscoverde	TARVISIO BOSCOVERDE
Tassignano	TASSIGNANO-CAPANNORI
Taurasi	TAURASI
Tavazzano	TAVAZZANO
Teano	TEANO
Teglio Veneto	TEGLIO VENETO
Telese Cerreto	TELESE-CERRETO
Teramo	TERAMO
Terlano-Andriano	TERLANO-ANDRIANO TERLAN-ANDRIAN
Terme Euganee-Abano-Montegr.	TERME EUGANEE-ABANO-MONTEGROTTO
Terme Vigliatore	TERME VIGLIATORE
Termini Imerese	TERMINI IMERESE
Termoli	TERMOLI
Ternate Varano Borghi	TERNATE-VARANO BORGHI
Terni	TERNI
Terni Cospea	TERNI COSPEA
Terno	TERNO
Terontola Cortona	TERONTOLA-CORTONA
Terracina	TERRACINA
Terrarossa - Tresana	TERRAROSSA-TRESANA
Terrenove	TERRENOVE
Terria	TERRIA
Terzigno	TERZIGNO
Terzo Montabone	TERZO-MONTABONE
Tezze Di Grigno	TEZZE DI GRIGNO
Thiene	THIENE
Thurio	THURIO
Tiera	TIERA
Tione Degli Abruzzi	TIONE DEGLI ABRUZZI
Tirano	TIRANO
Tissi Usini	TISSI-USINI
Tito	TITO
Tivoli	TIVOLI
Tocco Castiglione	TOCCO-CASTIGLIONE
Tolentino	TOLENTINO
Tollo Canosa Sannita	TOLLO-CANOSA SANNITA
Tombolo	TOMBOLO
Tommaso Natale	PALERMO TOMMASO NATALE
Tonco Alfiano	TONCO-ALFIANO
Tor Sapienza	TOR SAPIENZA
Tor Vergata	TOR VERGATA
Tora Presenzano	TORA-PRESENZANO
Torano Lattarico	TORANO-LATTARICO
Torchiara	TORCHIARA
Torino Dora	TORINO DORA GTT
Torino Lingotto	TORINO LINGOTTO
Torino Porta Susa	TORINO PORTA SUSA
Torino S. Paolo	
Torino Stura	TORINO STURA
Torralba	TORRALBA
Torrazza P.	TORRAZZA PIEMONTE
Torre Annunziata Centrale	TORRE ANNUNZIATA CENTRALE
Torre Annunziata C.le	TORRE ANNUNZIATA CENTRALE
Torre Annunziata Citta'	TORRE ANNUNZIATA CITTA
Torre Dei Passeri	TORRE DEI PASSERI
Torre Del Greco	TORRE DEL GRECO
Torre Del Lago Puccini	TORRE DEL LAGO PUCCINI
Torre De` Picenardi	TORRE DE' PICENARDI
Torre In Pietra-Palidoro	TORRE IN PIETRA-PALIDORO
Torre Melissa	TORRE MELISSA
Torre Orsaia	TORRE ORSAIA
Torre Pellice	TORRE PELLICE
Torre S.Giorgio	TORRE S. GIORGIO
Torreberetti	TORREBERETTI
Torrenieri	TORRENIERI-MONTALCINO
Torricella	TORRICELLA
Torricola	TORRICOLA
Torrile S. Polo	TORRILE-S. POLO
Torrita Di Siena	TORRITA DI SIENA
Tortona	TORTONA
Tortoreto Lido	TORTORETO LIDO
Torviscosa	TORVISCOSA
Trabia	TRABIA
Trani	TRANI
Trapani	TRAPANI
Trappa	TRAPPA
Trappeto	TRAPPETO
Travedona Biandronno	TRAVEDONA-BIANDRONNO
Travesio	TRAVESIO
Tre Croci	TRE CROCI
Trebaseleghe	TREBASELEGHE
Trebisacce	TREBISACCE
Trecate	TRECATE
Trecella	TRECELLA
Tremestieri	TREMESTIERI
Trento	TRENTO
Trepuzzi	TREPUZZI
Tresenda-Aprica-Teglio	TRESENDA-APRICA-TEGLIO
Trevi	TREVI
Treviglio	TREVIGLIO
Treviglio Ovest	TREVIGLIO OVEST
Trevignano Signoressa	TREVIGNANO-SIGNORESSA
Treviso C.	TREVISO CENTRALE
Trezzano S.N.	TREZZANO SUL NAVIGLIO
Trieste Aquilinia	
Trieste Centrale	TRIESTE CENTRALE
Trieste C.le	TRIESTE CENTRALE
Trinitapoli S.Ferdin. Di P.	TRINITAPOLI-S. FERDINANDO DI PUGLIA
Trinita` Bene Vagienna	TRINITA'-BENE VAGIENNA
Trino Vercellese	TRINO VERCELLESE
Triuggio-Ponte Albiate	TRIUGGIO-PONTE ALBIATE
Trivigno	TRIVIGNO
Trofarello	TROFARELLO
Troia Castelluccio Sauri	TROIA-CASTELLUCCIO SAURI
Tromello	TROMELLO
Tronzano	TRONZANO
Tropea	TROPEA
Tufo	TUFO
Tuoro Sul Trasimeno	TUORO SUL TRASIMENO
Tusa	TUSA
Tuturano	TUTURANO
Udine	UDINE
Ugovizza Valbruna	UGOVIZZA-VALBRUNA
Uras Mogoro	URAS-MOGORO
Urbisaglia Sforzacosta	URBISAGLIA-SFORZACOSTA
Ururi Rotello	URURI-ROTELLO
Venezia Santa Lucia	VENEZIA S. LUCIA
Verona Porta Nuova	VERONA PORTA NUOVA
Viterbo Porta Fiorentina	VITERBO PORTA FIORENTINA
Vada	VADA
Vaglia	VAGLIA
Vaglio Basilicata	VAGLIO BASILICATA
Vaiano	VAIANO
Vairano	VAIRANO-CAIANELLO
Valdaora - Anterselva	VALDAORA-ANTERSELVA OLANG-ANTHOLZ
Valdibrana	VALDIBRANA
Valenza	VALENZA
Valle Aurelia	VALLE AURELIA
Valle Di Maddaloni	VALLE DI MADDALONI
Valle Di Mercato S.Severino	VALLE DI MERCATO S. SEVERINO
Valle Lomellina	VALLE LOMELLINA
Vallecrosia	VALLECROSIA
Valledolmo	VALLEDOLMO
Vallelunga	VALLELUNGA
Vallo Della Luc. Castelnuovo	VALLO DELLA LUCANIA-CASTELNUOVO
Valmadonna	VALMADONNA
Valmadrera	VALMADRERA
Valmontone	VALMONTONE
Valtopina	VALTOPINA
Vandoies	VANDOIES VINTL
Vanzago Pogliano	VANZAGO-POGLIANO
Vaprio D`Agogna	VAPRIO D'AGOGNA
Varallo Pombia	VARALLO POMBIA
Varallo Sesia	VARALLO SESIA
Varano	VARANO
Varazze	VARAZZE
Varenna Esino	VARENNA-ESINO
Varese	VARESE
Varignana	VARIGNANA
Vasto S.Salvo	VASTO-S. SALVO
Vastogirardi	VASTOGIRARDI
Ve Asseggiano	VENEZIA ASSEGGIANO
Velletri	VELLETRI
Venafro	VENAFRO
Venetico	VENETICO
Venezia Carpenedo	VENEZIA CARPENEDO
Venezia Marittima	VENEZIA S. LUCIA
Venezia Mestre	VENEZIA MESTRE
Venezia Porto Marghera	VENEZIA PORTO MARGHERA
Venosa - Maschito	VENOSA-MASCHITO
Ventimiglia	VENTIMIGLIA
Venzone	VENZONE
Verbania-Pallanza	VERBANIA-PALLANZA
Verceia	VERCEIA
Vercelli	VERCELLI
Vercurago S.Girolamo	VERCURAGO-S. GIROLAMO
Verdello Dalmine	VERDELLO-DALMINE
Vergato	VERGATO
Vergiate	VERGIATE
Vergnasco	VERGNASCO
Vernante	VERNANTE
Vernazza	VERNAZZA
Vernio Montepiano Cantagallo	VERNIO-MONTEPIANO-CANTAGALLO
Verolanuova	VEROLANUOVA
Verolengo	VEROLENGO
Verona Ca` Di David	
Verona Porta Vescovo	VERONA PORTA VESCOVO
Verres	VERRES
Verzuolo	VERZUOLO
Vespolate	VESPOLATE
Vespri	PALERMO VESPRI
Vetralla	VETRALLA
Vezzano Ligure	VEZZANO LIGURE
Viadana Bresciana	VIADANA BRESCIANA
Viareggio	VIAREGGIO
Vibo Marina	VIBO MARINA
Vibo Valenzia Pizzo	VIBO VALENTIA-PIZZO
Vicarello	VICARELLO
Vicchio	VICCHIO
Vicenza	VICENZA
Vico Matrino	VICO MATRINO
Vicofertile	VICOFERTILE
Vicoforte San Michele	VICOFORTE-S. MICHELE
Vicovaro	VICOVARO
Vidalengo	VIDALENGO
Vietri Sul Mare	VIETRI SUL MARE-AMALFI
Vigevano	VIGEVANO
Vigliano Candelo	VIGLIANO-CANDELO
Vigliano D`Abruzzo	VIGLIANO D'ABRUZZO
Vigliano D`Asti	VIGLIANO D'ASTI
Vigna Di Valle	VIGNA DI VALLE
Vignale	VIGNALE
Vignale Riotorto	VIGNALE-RIOTORTO
Vignate	VIGNATE
Vigodarzere	VIGODARZERE
Vigone	VIGONE
Vigonza Pianiga	VIGONZA-PIANIGA
Villa Bonelli	VILLA BONELLI
Villa Cade`	VILLA CADE
Villa Castelli	VILLA CASTELLI
Villa Claudia	VILLA CLAUDIA
Villa Del Conte	VILLA DEL CONTE
Villa Di Tirano	VILLA DI TIRANO
Villa Literno	VILLA LITERNO
Villa Opicina	VILLA OPICINA
Villa Raverio	VILLA RAVERIO
Villa S.G.Cannitello	VILLA S. GIOVANNI-CANNITELLO
Villa San Giovanni	VILLA S. GIOVANNI
Villa San Sebastiano	VILLA S. SEBASTIANO
Villabartolomea	VILLABARTOLOMEA
Villabassa - Braies	VILLABASSA BRAIES/NIEDERDORF PRAGS
Villabate	
Villadossola	VILLADOSSOLA
Villafranca - Bagnone	VILLAFRANCA-BAGNONE
Villafranca C.	VILLAFRANCA-CANTARANA
Villafranca Di Verona	VILLAFRANCA DI VERONA
Villafranca P.	VILLAFRANCA PIEMONTE
Villafranca Tirrena	VILLAFRANCA TIRRENA-SAPONARA
Villalba	VILLALBA
Villamaggiore	VILLAMAGGIORE
Villamassargia Domusnovas	VILLAMASSARGIA-DOMUSNOVAS
Villanova	VILLANOVA
Villanova Di Reggiolo	VILLANOVA DI REGGIOLO
Villanova D`Arda	VILLANOVA D'ARDA
Villanova D`Ardenghi	VILLANOVA D'ARDENGHI
Villapiana Lido	VILLAPIANA LIDO
Villapiana Torre Cerchiara	VILLAPIANA-TORRE CERCHIARA
Villarosa	VILLAROSA
Villasanta	VILLASANTA
Villasor	VILLASOR
Villaspeciosa Uta	VILLASPECIOSA-UTA
Villastellone	VILLASTELLONE
Villaverla Montecchio	VILLAVERLA-MONTECCHIO
Villazzano	VILLAZZANO
Villeneuve	VILLENEUVE
Villetta	VILLETTA
Villetta Malagnino	VILLETTA-MALAGNINO
Villetta S. Romano	VILLETTA S. ROMANO
Vilpiano-Nalles	VILPIANO-NALLES VILPIAN-NALS
Vinchiaturo	VINCHIATURO
Vipiteno	VIPITENO VAL VIZZE/STERZING PFITSCH
Visano	VISANO
Visone	VISONE
Viterbo Porta Romana	VITERBO PORTA ROMANA
Vittoria	VITTORIA
Vittorio Veneto	VITTORIO VENETO
Vittuone Arluno	VITTUONE-ARLUNO
Vitulano Foglianise	VITULANO-FOGLIANISE
Vituso	VITUSO
Vizzini	VIZZINI-LICODIA
Voghera	VOGHERA
Vogogna Ossola	VOGOGNA OSSOLA
Voltana	VOLTANA
Volterra Saline - Pomarance	VOLTERRA-SALINE-POMARANCE
Zagarolo	ZAGAROLO
Zambra	ZAMBRA
Zambrone	ZAMBRONE
Zappulla	ZAPPULLA
Zinasco Nuovo	ZINASCO NUOVO
Zoagli	ZOAGLI
Albairate Vermezzo	ALBAIRATE
NA Piazza Garib.	NAPOLI PIAZZA GARIBALDI
S.Demetrio V.	S. DEMETRIO DE' VESTINI
Albairate V.	ALBAIRATE
Napoli Afragola	NAPOLI AFRAGOLA